"a" = (/turf/wall,/area/map)
"b" = (/turf/wall{icon_state = "wall-edge"},/area/map)
"c" = (/obj/item/orb,/turf/floor,/area/map)
"d" = (/turf/floor,/area/map)
"e" = (/turf/checkpoint/start,/area/map)
"f" = (/obj/trap/hole,/obj/sequence_controller/forward,/turf/floor,/area/map)
"g" = (/obj/trap/hole,/turf/floor,/area/map)
"h" = (/obj/door/blue,/turf/floor,/area/map)
"i" = (/turf/pit{icon_state = "floor-edge"},/area/map/pit)
"j" = (/obj/trap/spear,/turf/floor,/area/map)
"k" = (/obj/trap/spike,/turf/floor,/area/map)
"l" = (/obj/trap/blade_trail,/turf/floor{icon_state = "floor-hl"},/area/map)
"m" = (/obj/trap/blade_trail,/turf/floor{icon_state = "floor-h"},/area/map)
"n" = (/obj/trap/blade_trail,/obj/trap/blade{dir = 4},/turf/floor{icon_state = "floor-h"},/area/map)
"o" = (/obj/trap/blade_trail,/turf/floor{icon_state = "floor-hr"},/area/map)
"p" = (/turf/pit,/area/map/pit)
"q" = (/obj/item/talaria,/turf/floor,/area/map)
"r" = (/obj/trap/blade_trail,/turf/floor{icon_state = "floor-vt"},/area/map)
"s" = (/obj/trap/blade_trail,/turf/floor{icon_state = "floor-v"},/area/map)
"t" = (/obj/trap/blade_trail,/obj/trap/blade{dir = 8},/turf/floor{icon_state = "floor-h"},/area/map)
"u" = (/obj/trap/blade_trail,/obj/trap/blade,/turf/floor{icon_state = "floor-v"},/area/map)
"v" = (/obj/trap/blade_trail,/turf/floor{icon_state = "floor-vb"},/area/map)
"w" = (/obj/door/yellow,/turf/floor,/area/map)
"x" = (/obj/item/key/red,/turf/floor,/area/map)
"y" = (/turf/checkpoint/yellow_zone,/area/map)
"z" = (/obj/trap/blade_trail,/obj/trap/blade{dir = 1},/turf/floor{icon_state = "floor-v"},/area/map)
"A" = (/turf/checkpoint/blue_zone,/area/map)
"B" = (/obj/door/red,/turf/floor,/area/map)
"C" = (/obj/trap/blade_trail,/obj/trap/blade{dir = 8; speed = 4},/turf/floor{icon_state = "floor-h"},/area/map)
"D" = (/obj/item/key/yellow,/turf/floor,/area/map)
"E" = (/obj/trap/blade_trail,/obj/trap/blade{dir = 4; speed = 4},/turf/floor{icon_state = "floor-h"},/area/map)
"F" = (/obj/item/key/blue,/turf/floor,/area/map)
"G" = (/turf/water{icon_state = "water-edge"},/area/map/water)
"H" = (/turf/water,/area/map/water)
"I" = (/obj/trap/blade_trail,/obj/trap/blade{dir = 1; speed = 4},/turf/floor{icon_state = "floor-vt"},/area/map)
"J" = (/obj/trap/blade_trail,/obj/trap/blade{speed = 4},/turf/floor{icon_state = "floor-v"},/area/map)
"K" = (/turf/checkpoint/green_zone,/area/map)
"L" = (/obj/item/snorkel,/turf/floor,/area/map)
"M" = (/obj/trap/blade_trail,/obj/trap/blade{dir = 1; speed = 4},/turf/floor{icon_state = "floor-v"},/area/map)
"N" = (/obj/trap/blade_trail,/obj/trap/blade{dir = 1; speed = 4},/turf/floor{icon_state = "floor-vb"},/area/map)
"O" = (/obj/item/key/green,/turf/floor,/area/map)
"P" = (/obj/door/green,/turf/floor,/area/map)
"Q" = (/turf/flag,/area/map)

(1,1,1) = {"
aaaaaaaaaaaaaaaaaaaaaaaaaaaaaaaaaaaaaaaaaaaaaaaaaaaaaaaaaaaaaaaaaaaaaaaaaaaaaaaaaaaaaaaaaaaaaaaaaaaaa
aaaaaaaaaaaaaaaaaaaaaaaaaaaaaaaaaaaaaaaaaaaaaaaaaaaaaaaaaaaaaaaaaaaaaaaaaaaaaaaaaaaaaaaaaaaaaaaaaaaaa
aaaaaaaaaaaaaaaaaaaaaaaaaaaaaaaaaaaaaaaaaaaaaaaaaaaaaaaaaaaaaaaaaaaaaaaaaaaaaaaaaaaaaaaaaaaaaaaaaaaaa
aaaaaaaaaaaaaaaaaaaaaaaaaaaaaaaaaaaaaaaaaaaaaaaaaaaaaaaaaaaaaaaaaaaaaaaaaaaaaaaaaaaaaaaaaaaaaaaaaaaaa
aaaaaaaaaaaaaaaaaaaaaaaaaaaaaaaaaaaaaaaaaaaaaaaaaaaaaaaaaaaaaaaaaaaaaaaaaaaaaaaaaaaaaaaaaaaaaaaaaaaaa
aaaaaaaaaaaaaaaaaaaaaaaaaaaaaaaaaaaaaaaaaaaaaaaaaaaaaaaaaaaaaaaaaaaaaaaaaaaaaaaaaaaaaaaaaaaaaaaaaaaaa
aaaaaaaaaaaaaaaaaaaaaaaaaaaaaaaaaaaaaaaaaaaaaaaaaaaaaaaaaaaabbbbbbaaaaaaaaaaaaaaaaaaaaaaaaaaaaaaaaaaa
aaaaaaaaaaaaaaaaaaaaaaaaaaaaaaaaaaaaaaaaaaaaaaaaaaaaaaaaaaaaccccccaaaaaaaaaaaaaaabbbaaaaaaaaaaaaaaaaa
aaaaaaaaaaaaaaaaaaaaaaaaaaaaaaaaaaaaaaaaaaaaaaaaaaaaaaaaaabbcaaaacaaaaaaaaaaaaaaadddaaaaaaaaaaaaaaaaa
aaaaaaaaaaaaaaaaaaaaaaaaaaaaaaaaaaaaaaaaaaaaaaaaaaaaaaaaaacccaabbcbbaaaaaaaaaaaaadedaaaaaaaaaaaaaaaaa
aaaaaaaaaaaaaaaaaaaaaaaaaaaaaaaaaaaaaaaaaaaaaaaaaaaaaaaaaacaaaacccccaaaaaaaaaaaaadddaaaaaaaaaaaaaaaaa
aaaaaaaaaaaaaaaaaaaaaaaaaaaaaaaaaaaaaaaaaaaaaaaaaaaaaaabbbcaabbcaaacbbaaaaaaaaaaaafaaaaaaaaaaaaaaaaaa
aaaaaaaaaaaaaaaaaaaaaaaaaaaaaaaaaaaaaaaaaaaaaaaaaaaaaaaccccaacccaaacccaaaaaaaaaaaagaaaaaaaaaaaaaaaaaa
aaaaaaaaaaaaaaaaaaaaaaaaaaaaaaaaaaaaaaaaaaaaaaaaaaaaaaacaacbbcaaaaaaacbbbbbbbbbbbbgbaaaaaaaaaaaaaaaaa
aaaaaaaaaaaaaaaaaaaaaaaaaaaaaaaaaaaaaaaaaaaaaaaaaaaaaaacaaccccaaaaaaacccccccccccchccaaaaaaaaaaaaaaaaa
aaaaaaaaaaaaaaaaaaaaaaaaaaaaaaaaaaaabbbbbbbbbbaaaaaaaaacaaaaacbbaaabbcaaaaaaaaaaaaacaaaaaaaaaaaaaaaaa
aaaaaaaabbbbbbbbbbbbbaaaaaaaaaaaaaaaccccccccccaaaabbbbbcbbaaacccaaacccaaaaaaaaaaaaacbbbbaaaaaaaaaaaaa
aaaaaaaaiiijikkkiiiiiaaaaaaaaaaaaaaacabbbbbbacaaaaccclmnmoaaaaacbbbcaaaaaaaaaaaaaaacccccaaaaaaaaaaaaa
aaaaaaaapppcckqkpppppbbbbbbbbbbbbbbbcaccccccacaaaacaaaacaaaabaacccccaaaaaaaaaaaaaaakaaacaaaaaaaaaaaaa
aaaaaaaapppcikkkpppppccccccccccccccccacabbbcacaaaacaaaacaaaaraaaacaaaaaaaaaaaaaaaaakbbbcaaaaaaaaaaaaa
aaaaaaaapppcpiiipppppaaaaaaaaaaaaaabbbcackkcacaaaacaaaacbbbbsbbbbcaaaaaaaaaaaaaaaaacccccaaaaaaaaaaaaa
aaaaaaaapplmmmtmmmoppaaaaaaaabbbbbackkcacabbbcaaaacaaaacccccucccccaaaaaaaaaaaaaaaaacaaaaaaaaaaaaaaaaa
aaaaaaaappiiiiciiiippaaaaaaaaiiiiiacabbbcaccccabbbcbbbaaaaaasaaaaaaaaaaaaaaaaaaaaaacaaaaaaaaaaaaaaaaa
aaaaaaaappppppcppppppaaaaaaaapppppbcaccccaiaajajdddddjaaaaaavaaaaaaaaaaaaaaaaaaaaaacaaaaaaaaaaaaaaaaa
aaaaaaaappppppcppppppaaaaaaaappcccccacaaaapaaaadddddddaaaaaacaaaaaaaaaaaaaaaaaaaaaacaaaaaaaaaaaaaaaaa
aaaaaaaapppppccppppppaaaaaaaappciiaaacabbbpbbbbddiiiddbbbbbbcaaaaaaaaaaaaaaaaaaaaaacaaaaaaaaaaaaaaaaa
aaaaaaaapppppciprppppaaaaaaaappcppaaacajccccccwddpxpddcccccccaaaaaaaaaaaaaaaaaaaaaacbbbbbbaaaaaaaaaaa
aaaaaaaappppjcccsppppaaaaaaabbbcbbbaacbbcaaaaaaddpipddaabdbaaaaaaaaaaaaaaaaaaaaaaaacccccccaaaaaaaaaaa
aaaaaaaappppiiiisppppaaaaaaalmmtmmoaaccccaaaaaadddddddaadddaaaaaaaaaaaaabbbbbbbbbbbbbbabbcaaaaaaaaaaa
aaaaaaaappppppppuppppaaaaaaabbbcbbbaaaaajaaaaaajdddddjaadydaaaaaaaaaaaaaccccccccccccccacccaaaaaaaaaaa
aaaaaaaappppppppsppppaaaaaaalmmnmmoaaaaaaaaaaaaaararbaaadddaaaaaaaaaaaaacaaaaaaaaaaaacacakaaaaaaaaaaa
aaaaaaaappppjpppscpppaaaaaaabbbcbbbaaaaaaaaaaaaaasasjaaaaaaaaaaaaaaaaaaacaaaaaaaaaabbcacbkaaaaaaaaaaa
aaaaaaaappppccccvipppaaaaaaalmmtmmoaaaaaaaaaaaaaasbsaaaaaaaaaaaaaaaaaaaacaaaaaaaaaacccacccaaaaaaaaaaa
aaaaaaaappppciiiippppaaaaaaaaaacaaaaaaaaaaaaaaaaascsaaaaaaaaaaaaaaaaaaaacaaaaaaaaaacacbbacaaaaaaaaaaa
aaaaaaaappppcccppppppaaaaaaaaaacaaaaaaaaaaaaaaaabsasaaaaaaaaaaaaaaaabbbbcabbbaaaaaacacccacaaaaaaaaaaa
aaaaaaaappppiicppppppaaabbbbbbbcaaaaaaaaaaaaaaaajsasaaaaaaaaaaaaaaaarccccaccraaaaaacaaacacaaaaaaaaaaa
aaaaaaaapplmmmtmmmoppaaaiiiiccccaaaaaaaaaaaaaaaaasbsaaaaaaaaaaaaaaaasaaaaaaasaaaaaacaaacacaaaaaaaaaaa
aaaaaaaappiiiiciiiippaaapabacaaaaaaaaaaaaaaaaaaaauczaaaaaaaaaaaaaaaasaabbbaasaaaaaacaaacacaaaaaaaaaaa
aaaaaaaappppppcpcccppaaaparacaaaaaaaaaaaaaaaaaaaasasbaaaaaaaaaaaaaaasbadddabsaaaaaacaaacacbbbaaaaaaaa
aaaaaaaappppppcpcicppbbbpbsbcaaaaaaaaaaaaaaaaaaaasasjaaaaaaaaaaaaaaaucadAdacuaaaaaacaaacaccccaaaaaaaa
aaaaaaaappppppcccpcpccccccuccaaaaaaaaaaaaaaaaaaaasbsaaaaaaaaaaaaaaaasaadddaasbbbaaacaaakaaaakaaaaaaaa
aaaaaaaappppppiiipcpcaaaaasaaaaaaaaaaaaaaaaabaaaascsaaaaaaaaaaaaaaaasaaadaaascccaaacaaakbbbbkaaaaaaaa
aaaaaaaappppppppppcccaaaaavaaaaaaaaaaaabbbbbjaaabsasaaaaaaaaaaaaaaaasbbbdbbbsaacaaacaaaccccccaaaaaaaa
aaaaaaaaaaaaaaaaaaaaaaaaaaaaaaaaaaaaaaajcccccaaajsasaaaaaaaaaaaaaaaavcccccccvaacaaacaaaaaaaaaaaaaaaaa
aaaaaaaaaaaaaaaaaaaaaaaaaaaaaaaaaaaaaaaacabbcaaabvbvbaaaaaaaaaaaaaaaaaaacaaaaaacbbbcaaaaaaaaaaaaaaaaa
aaaaaaaaaaaaaaaaaaaaaaaaaaaaaaaaaaaaaaaacacccaaajdddjaaaaaaaaaaaaaaaaaaacaaaaaacccccaaaaaaaaaaaaaaaaa
aaaaaaaaaaaaaaaaaaaaaaaaaaaaaaaaaaaaaaaakakabbbbdddddbbbbbbbbaaaaaaaaaaacaaaaaaaaaaaaaaaaaaaaaaaaaaaa
aaaaaaaaaaaaaaaaaaaaaaaaaaabbbbbbbbbbbaakakaccccddjddBcccccccaaaaaaaaaaacaaaaaaaaaaaaaaaaaaaaaaaaaaaa
aaaaaaaaaaaaaaaaaaaaaaaaaaaiiiiiiiiiiiaakakbcaaadddddaaaabbbcbbbaaaaaaaacaaaaaaaaaaaaaaaaaaaaaaaaaaaa
aaaaaaaaaaaaaaaaaaaaaaaaaaappppppcccppaacacccaaajdddjaaaalmmCmmoaaaaaaaacaaaaaaaaaaaaaaaaaaaaaaaaaaaa
aaaaaaaaaaaaaaaaaaaaaaaaaaapccccpcicppaacbbbbbbaaaaaaaaaaabbcaaaaaaaaaaacaaaaaaaaaaaaaaaaaaaaaaaaaaaa
aaaaaaaaaaaaaaaaaaaaaaaaaaapciicpcpcppaacccccccaaaaaaaaaaacccaaaaaaabbbbcbbbbaaaaaaaaaaaaaaaaaaaaaaaa
aaaaaaaaaaaaaaaaaaaaaaaaaaakkkpcpcpcppbbbbbbbacbbbbbbbabbbcbbbaaaaaalmmmtmmmoaaaaaaaaaaaaaaaaaaaaaaaa
aaaaaaaaaaaaaaaaaaaaaaaaaaakDkpcpcpccccccccccacckkkccjalmmEmmoaaaaaaiiiiiiciiaaaaaaaaaaaaaaaaaaaaaaaa
aaaaaaaaaaaaaaaaaaaaaaaaaaakkkpcpcpiiiaaaaabcbbbbbbbcaaaaacbbaaaaaaalmmmnmmmoaaaaaaaaaaaaaaaaaaaaaaaa
aaaaaaaaaaaaaaaaaaaaaaaaaaaiiipcpccccpaaaaajcccckkkccaaaaacccaaaaaaaiiciiiiiiaaaaaaaaaaaaaaaaaaaaaaaa
aaaaaaaaaaaaaaaaaaaaaaaaaaappppcpiiicpaaaaaaaaaaaaaajaaaabbbcbbbaaaalmmmtmmmoaaaaaaaaaaaaaaaaaaaaaaaa
aaaaaaaaaaaaaaaaaaaaaaaaaaappppccccccpaaaaaaaaaaaaaaaaaaalmmCmmoaaaaiiiiciiiiaaaaaaaaaaaaaaaaaaaaaaaa
aaaaaaaaaaaaaaaaaaaaaaaaaaappppiiiiiipaaaaaaaaaaaaaaaaaaaabbcaaaaaaappppcppppaaaaaaaaaaaaaaaaaaaaaaaa
aaaaaaaaaaaaaaaaaaaaaaaaaaaaaaaaaaaaaaaaaaaaaaaaaaaaaaaaaacccaaaaaaappppcppppaaaaaaaaaaaaaaaaaaaaaaaa
aaaaaaaaaaaaaaaaaaaaaaaaaaaaaaaaaaaaaaaaaaaaaaaaaaaaaaabbbcbbbaaaaaapppccppppaaaaaaaaaaaaaaaaaaaaaaaa
aaaaaaaaaaaaaaaaaaaaaaaaaaaaaaaaaaaaaaaaaaaaaaaaaaaaaaalmmEmmoaaaaaapppcippppaaaaaaaaaaaaaaaaaaaaaaaa
aaaaaaaaaaaaaaaaaaaaaaaaaaaaaaaaaaaaaaaaaaaaaaaaaaaaaaaaaacaaaaaaaaapppcccpppaaaaaaaaaaaaaaaaaaaaaaaa
aaaaaaaaaaaaaaaaaaaaaaaaaaaaaaaaaaaaaaaaaaaaaaaaaaaaaaaabbcbbaaaaaaapppiicpppaaaaaaaaaaaaaaaaaaaaaaaa
aaaaaaaaaaaaaaaaaaaaaaaaaaaaaaaaaaaaaaaaaaaaaaaaaaaaaaaaiiiiiaaaaaaappppccpppaaaaaaaaaaaaaaaaaaaaaaaa
aaaaaaaaaaaaaaaaaaaaaaaaaaaaaaaaaaaaaaaaaaaaaaaaaaaaaaaalmEmoaaaaaaappppcipppaaaaaaaaaaaaaaaaaaaaaaaa
aaaaaaaaaaaaaaaaaaaaaaaaaaaaaaaaaaaaaaaaaaaaaaaaaaaaaaaaiiiiiaaaaaaapppdddpppaaaaaaaaaaaaaaaaaaaaaaaa
aaaaaaaaaaaaaaaaaaaaaaaaaaaaaaaaaaaaaaaaaaaaaaaaaaaaaaaalmCmoaaaaaaapppdFdpppaaaaaaaaaaaaaaaaaaaaaaaa
aaaaaaaaaaaaaaaaaaaaaaaaaaaaaaaaaaaaaaaaaaaaaaaaaaaaaaaaiiiiiaaaaaaapppdddpppaaaaaaaaaaaaaaaaaaaaaaaa
aaaaaaaaaaaaaabbbbbbbbbbbbbbbbbbbbbbbbbaaaaaaaaaaaaaaaaalmEmoaaaaaaaaaaaaaaaaaaaaaaaaaaaaaaaaaaaaaaaa
aaaaaaaaaaaaaaGGGGGGGGGGGGGGGGGGGGGGGGGaaaaaaaaaaaaaaaaaiiiiiaaaaaaaaaaaaaaaaaaaaaaaaaaaaaaaaaaaaaaaa
aaaaaaaaaaaaaaHHHHHHHHHHaaaadrrrrrIrrrdabbbaaabbbbbbbaaalmCmoaaaaaaaaaaaaaaaaaaaaaaaaaaaaaaaaaaaaaaaa
aaaaaaaaaaaaaaHHHHHHHHHHaaaadsssssssssdbdddaaacccccccaaaiiiiiaaaaaaaaaaaaaaaaaaaaaaaaaaaaaaaaaaaaaaaa
aaaaaaaaaaaaaaHHHHHHHHHHaaaadssssssJssdddKdaaacGGGGGcaaalmEmoaaaabbbbbaaaaaaaaaaaaaaaaaaaaaaaaaaaaaaa
aaaaaaaaaaaaaaHHHHHHHHHHaaaadsssssssssdadddaaacHHHHHcaaaiiiiiaaaaGGGGGaaaaaaaaaaaaaaaaaaaaaaaaaaaaaaa
aaaaaaaaaaaaaajdjHHHHHHHbbbbdssJssssssdbbbaaaacHHHHHcbbbbjdjbbbbbHHHHHaaaaaaaaaaaaaaaaaaaaaaaaaaaaaaa
aaaaaaaaaaaaaadLdkkkcHHHckkkdsMssJssMsdcccaaaacHHHHHcccccdddcccccHHHHHaaaaaaaaaaaaaaaaaaaaaaaaaaaaaaa
aaaaaaaaaaaaaajdjGGGcHHHcaaadJssssssssdaacaaaacHHHHHaaaaajdjaaaaaHHHHHaaaaaaaaaaaaaaaaaaaaaaaaaaaaaaa
aaaaaaaaaaaaaaGGGHHHcHHHcaaadsssssssssdaacbbbbcbbbaaaaaaaaaaaaaaaHHHHHaaaaaaaaaaaaaaaaaaaaaaaaaaaaaaa
aaaaaaaaaaaaaaHHHHHHckkkcaaadssssssssJdaacccccccccaaaaaaaaaaaaaaaaHHHaaaaaaaaaaaaaaaaaaaaaaaaaaaaaaaa
aaaaaaaaaaaaaaHHHHHHGGGGaaaadsssssssssdaaaaaaaaaacaaaaaaaaaaaaaaaalCoaaaaaaaaaaaaaaaaaaaaaaaaaaaaaaaa
aaaaaaaaaaaaaaHHHHHHHHHHbbbbdvvvNvvvvvdaaaaaaaaaacaaaaaaaaaaaaaaaaGGGaaaaaaaaaaaaaaaaaaaaaaaaaaaaaaaa
aaaaaaaaaaaaaaHHHHHHHHHHGGGGGGGGGGGGGGGaaaaaaaaaacaaaaaaaaaaaaaaaalEoaaaaaaaaaaaaaaaaaaaaaaaaaaaaaaaa
aaaaaaaaaaaaaaaaaaaaaaaaaaaaaaaaaaaaaaaaaaaaaaaaacaaaaaaaaaaaaaaaaGGGaaaaaaaaaaaaaaaaaaaaaaaaaaaaaaaa
aaaaaaaaaaaaaaaaaaaaaaaaaaaaaaaaaaaaaaaaaaaaaabbbcaaaaaaaaaaaaaaaalCoaaaaaaaaaaaaaaaaaaaaaaaaaaaaaaaa
aaaaaaaaaaaaaaaaaaaaaaaaaaaaaaaaaaaaaaaaaaaaaackkcaaaaaaaaaaaaaaabGGGbaaaaaaaaaaaaaaaaaaaaaaaaaaaaaaa
aaaaaaaaaaaaaaaaaaaaaaaaaaaaaaaaaaaaaaaaaaaabbcaaaaaaaaaaaaaaaaaaGHHHGaaaaaaaaaaaaaaaaaaaaaaaaaaaaaaa
aaaaaaaaaaaaaaaaaaaaaaaaaaaaaaaaaaaaaaaaaaaacccaaaaaaaaaaaaaaaaaaHdddHaaaaaaaaaaaaaaaaaaaaaaaaaaaaaaa
aaaaaaaaaaaaaaaaaaaaaaaaaaaaaaaaaaaaaaaaaaaakajaaaaaaaaaaaaaaaaaaHdOdHaaaaaaaaaaaaaaaaaaaaaaaaaaaaaaa
aaaaaaaaaaaaaaaaaaaaaaaaaaaaaaaaaaaaaaaaaaaakbbbaaaaaaaaaaaaaaaaaHdddHaaaaaaaaaaaaaaaaaaaaaaaaaaaaaaa
aaaaaaaaaaaaaaaaaaaaaaaaaaaaaaaaaaaaaaaaaaaacccjaaaaaaaaaaaaaaaaaHGGGHaaaaaaaaaaaaaaaaaaaaaaaaaaaaaaa
aaaaaaaaaaaaaaaaaaaaaaaaaaaaaaaaaaaaaaaaaaaaaakaaaaaaaaaaaaaaaaaaaaaaaaaaaaaaaaaaaaaaaaaaaaaaaaaaaaaa
aaaaaaaaaaaaaaaaaaaaaaaaaaaaaaaaaaaaaaaaaaabbbkaaaaaaaaaaaaaaaaaaaaaaaaaaaaaaaaaaaaaaaaaaaaaaaaaaaaaa
aaaaaaaaaaaaaaaaaaaaaaaaaaaaaaaaaaaaaaaaaaajcccaaaaaaaaaaaaaaaaaaaaaaaaaaaaaaaaaaaaaaaaaaaaaaaaaaaaaa
aaaaaaaaaaaaaaaaaaaaaaaaaaaaaaaaaaaaaaaaaaaakaaaaaaaaaaaaaaaaaaaaaaaaaaaaaaaaaaaaaaaaaaaaaaaaaaaaaaaa
aaaaaaaaaaaaaaaaaaaaaaaaaaaaaaaaaaaaaaaaaaaakaaaaaaaaaaaaaaaaaaaaaaaaaaaaaaaaaaaaaaaaaaaaaaaaaaaaaaaa
aaaaaaaaaaaaaaaaaaaaaaaaaaaaaaaaaaaaaaaaabbbPbbbaaaaaaaaaaaaaaaaaaaaaaaaaaaaaaaaaaaaaaaaaaaaaaaaaaaaa
aaaaaaaaaaaaaaaaaaaaaaaaaaaaaaaaaaaaaaaaaiiiiiiiaaaaaaaaaaaaaaaaaaaaaaaaaaaaaaaaaaaaaaaaaaaaaaaaaaaaa
aaaaaaaaaaaaaaaaaaaaaaaaaaaaaaaaaaaaaaaaapppppppaaaaaaaaaaaaaaaaaaaaaaaaaaaaaaaaaaaaaaaaaaaaaaaaaaaaa
aaaaaaaaaaaaaaaaaaaaaaaaaaaaaaaaaaaaaaaaappdddppaaaaaaaaaaaaaaaaaaaaaaaaaaaaaaaaaaaaaaaaaaaaaaaaaaaaa
aaaaaaaaaaaaaaaaaaaaaaaaaaaaaaaaaaaaaaaaappdQdppaaaaaaaaaaaaaaaaaaaaaaaaaaaaaaaaaaaaaaaaaaaaaaaaaaaaa
aaaaaaaaaaaaaaaaaaaaaaaaaaaaaaaaaaaaaaaaappdddppaaaaaaaaaaaaaaaaaaaaaaaaaaaaaaaaaaaaaaaaaaaaaaaaaaaaa
aaaaaaaaaaaaaaaaaaaaaaaaaaaaaaaaaaaaaaaaappiiippaaaaaaaaaaaaaaaaaaaaaaaaaaaaaaaaaaaaaaaaaaaaaaaaaaaaa
aaaaaaaaaaaaaaaaaaaaaaaaaaaaaaaaaaaaaaaaapppppppaaaaaaaaaaaaaaaaaaaaaaaaaaaaaaaaaaaaaaaaaaaaaaaaaaaaa
aaaaaaaaaaaaaaaaaaaaaaaaaaaaaaaaaaaaaaaaaaaaaaaaaaaaaaaaaaaaaaaaaaaaaaaaaaaaaaaaaaaaaaaaaaaaaaaaaaaaa
aaaaaaaaaaaaaaaaaaaaaaaaaaaaaaaaaaaaaaaaaaaaaaaaaaaaaaaaaaaaaaaaaaaaaaaaaaaaaaaaaaaaaaaaaaaaaaaaaaaaa
aaaaaaaaaaaaaaaaaaaaaaaaaaaaaaaaaaaaaaaaaaaaaaaaaaaaaaaaaaaaaaaaaaaaaaaaaaaaaaaaaaaaaaaaaaaaaaaaaaaaa
aaaaaaaaaaaaaaaaaaaaaaaaaaaaaaaaaaaaaaaaaaaaaaaaaaaaaaaaaaaaaaaaaaaaaaaaaaaaaaaaaaaaaaaaaaaaaaaaaaaaa
aaaaaaaaaaaaaaaaaaaaaaaaaaaaaaaaaaaaaaaaaaaaaaaaaaaaaaaaaaaaaaaaaaaaaaaaaaaaaaaaaaaaaaaaaaaaaaaaaaaaa
aaaaaaaaaaaaaaaaaaaaaaaaaaaaaaaaaaaaaaaaaaaaaaaaaaaaaaaaaaaaaaaaaaaaaaaaaaaaaaaaaaaaaaaaaaaaaaaaaaaaa
aaaaaaaaaaaaaaaaaaaaaaaaaaaaaaaaaaaaaaaaaaaaaaaaaaaaaaaaaaaaaaaaaaaaaaaaaaaaaaaaaaaaaaaaaaaaaaaaaaaaa
"}
