"a" = (/turf/wall,/area/map)
"b" = (/turf/wall{icon_state = "wall-edge"},/area/map)
"c" = (/obj/item/orb,/turf/floor,/area/map)
"d" = (/turf/floor,/area/map)
"e" = (/obj/trap/arrow_shooter{tag = "icon-arrow-shooter (WEST)"; icon_state = "arrow-shooter"; dir = 8},/obj/pressure_plate_wire,/turf/floor,/area/map)
"f" = (/turf/checkpoint/start,/area/map)
"g" = (/obj/trap/pressure_plate,/obj/pressure_plate_wire,/turf/floor,/area/map)
"h" = (/obj/pressure_plate_wire,/turf/floor,/area/map)
"i" = (/obj/door/blue,/turf/floor,/area/map)
"j" = (/turf/pit{icon_state = "floor-edge"},/area/map/pit)
"k" = (/obj/trap/spear,/turf/floor,/area/map)
"l" = (/obj/trap/spike,/turf/floor,/area/map)
"m" = (/obj/trap/blade_trail,/turf/floor{icon_state = "floor-hl"},/area/map)
"n" = (/obj/trap/blade_trail,/turf/floor{icon_state = "floor-h"},/area/map)
"o" = (/obj/trap/blade_trail,/obj/trap/blade{dir = 4},/turf/floor{icon_state = "floor-h"},/area/map)
"p" = (/obj/trap/blade_trail,/turf/floor{icon_state = "floor-hr"},/area/map)
"q" = (/turf/pit,/area/map/pit)
"r" = (/obj/item/talaria,/turf/floor,/area/map)
"s" = (/obj/trap/blade_trail,/turf/floor{icon_state = "floor-vt"},/area/map)
"t" = (/obj/trap/blade_trail,/turf/floor{icon_state = "floor-v"},/area/map)
"u" = (/obj/trap/blade_trail,/obj/trap/blade{dir = 8},/turf/floor{icon_state = "floor-h"},/area/map)
"v" = (/obj/trap/blade_trail,/obj/trap/blade,/turf/floor{icon_state = "floor-v"},/area/map)
"w" = (/obj/trap/blade_trail,/turf/floor{icon_state = "floor-vb"},/area/map)
"x" = (/obj/door/yellow,/turf/floor,/area/map)
"y" = (/obj/item/key/red,/turf/floor,/area/map)
"z" = (/turf/checkpoint/yellow_zone,/area/map)
"A" = (/obj/trap/blade_trail,/obj/trap/blade{dir = 1},/turf/floor{icon_state = "floor-v"},/area/map)
"B" = (/turf/checkpoint/blue_zone,/area/map)
"C" = (/obj/door/red,/turf/floor,/area/map)
"D" = (/obj/trap/blade_trail,/obj/trap/blade{dir = 8; speed = 4},/turf/floor{icon_state = "floor-h"},/area/map)
"E" = (/obj/item/key/yellow,/turf/floor,/area/map)
"F" = (/obj/trap/blade_trail,/obj/trap/blade{dir = 4; speed = 4},/turf/floor{icon_state = "floor-h"},/area/map)
"G" = (/obj/item/key/blue,/turf/floor,/area/map)
"H" = (/turf/water{icon_state = "water-edge"},/area/map/water)
"I" = (/turf/water,/area/map/water)
"J" = (/obj/trap/blade_trail,/obj/trap/blade{dir = 1; speed = 4},/turf/floor{icon_state = "floor-vt"},/area/map)
"K" = (/obj/trap/blade_trail,/obj/trap/blade{speed = 4},/turf/floor{icon_state = "floor-v"},/area/map)
"L" = (/turf/checkpoint/green_zone,/area/map)
"M" = (/obj/item/snorkel,/turf/floor,/area/map)
"N" = (/obj/trap/blade_trail,/obj/trap/blade{dir = 1; speed = 4},/turf/floor{icon_state = "floor-v"},/area/map)
"O" = (/obj/trap/blade_trail,/obj/trap/blade{dir = 1; speed = 4},/turf/floor{icon_state = "floor-vb"},/area/map)
"P" = (/obj/item/key/green,/turf/floor,/area/map)
"Q" = (/obj/door/green,/turf/floor,/area/map)
"R" = (/turf/flag,/area/map)

(1,1,1) = {"
aaaaaaaaaaaaaaaaaaaaaaaaaaaaaaaaaaaaaaaaaaaaaaaaaaaaaaaaaaaaaaaaaaaaaaaaaaaaaaaaaaaaaaaaaaaaaaaaaaaaa
aaaaaaaaaaaaaaaaaaaaaaaaaaaaaaaaaaaaaaaaaaaaaaaaaaaaaaaaaaaaaaaaaaaaaaaaaaaaaaaaaaaaaaaaaaaaaaaaaaaaa
aaaaaaaaaaaaaaaaaaaaaaaaaaaaaaaaaaaaaaaaaaaaaaaaaaaaaaaaaaaaaaaaaaaaaaaaaaaaaaaaaaaaaaaaaaaaaaaaaaaaa
aaaaaaaaaaaaaaaaaaaaaaaaaaaaaaaaaaaaaaaaaaaaaaaaaaaaaaaaaaaaaaaaaaaaaaaaaaaaaaaaaaaaaaaaaaaaaaaaaaaaa
aaaaaaaaaaaaaaaaaaaaaaaaaaaaaaaaaaaaaaaaaaaaaaaaaaaaaaaaaaaaaaaaaaaaaaaaaaaaaaaaaaaaaaaaaaaaaaaaaaaaa
aaaaaaaaaaaaaaaaaaaaaaaaaaaaaaaaaaaaaaaaaaaaaaaaaaaaaaaaaaaaaaaaaaaaaaaaaaaaaaaaaaaaaaaaaaaaaaaaaaaaa
aaaaaaaaaaaaaaaaaaaaaaaaaaaaaaaaaaaaaaaaaaaaaaaaaaaaaaaaaaaabbbbbbaaaaaaaaaaaaaaaaaaaaaaaaaaaaaaaaaaa
aaaaaaaaaaaaaaaaaaaaaaaaaaaaaaaaaaaaaaaaaaaaaaaaaaaaaaaaaaaaccccccaaaaaaaaaaaaaaabbbbbbbbbaaaaaaaaaaa
aaaaaaaaaaaaaaaaaaaaaaaaaaaaaaaaaaaaaaaaaaaaaaaaaaaaaaaaaabbcaaaacaaaaaaaaaaaaaaaddddddddeaaaaaaaaaaa
aaaaaaaaaaaaaaaaaaaaaaaaaaaaaaaaaaaaaaaaaaaaaaaaaaaaaaaaaacccaabbcbbaaaaaaaaaaaaadfdghhhheaaaaaaaaaaa
aaaaaaaaaaaaaaaaaaaaaaaaaaaaaaaaaaaaaaaaaaaaaaaaaaaaaaaaaacaaaacccccaaaaaaaaaaaaaddddddddeaaaaaaaaaaa
aaaaaaaaaaaaaaaaaaaaaaaaaaaaaaaaaaaaaaaaaaaaaaaaaaaaaaabbbcaabbcaaacbbaaaaaaaaaaaacaaaaaaaaaaaaaaaaaa
aaaaaaaaaaaaaaaaaaaaaaaaaaaaaaaaaaaaaaaaaaaaaaaaaaaaaaaccccaacccaaacccaaaaaaaaaaaacaaaaaaaaaaaaaaaaaa
aaaaaaaaaaaaaaaaaaaaaaaaaaaaaaaaaaaaaaaaaaaaaaaaaaaaaaacaacbbcaaaaaaacbbbbbbbbbbbbcbaaaaaaaaaaaaaaaaa
aaaaaaaaaaaaaaaaaaaaaaaaaaaaaaaaaaaaaaaaaaaaaaaaaaaaaaacaaccccaaaaaaacccccccccccciccaaaaaaaaaaaaaaaaa
aaaaaaaaaaaaaaaaaaaaaaaaaaaaaaaaaaaabbbbbbbbbbaaaaaaaaacaaaaacbbaaabbcaaaaaaaaaaaaacaaaaaaaaaaaaaaaaa
aaaaaaaabbbbbbbbbbbbbaaaaaaaaaaaaaaaccccccccccaaaabbbbbcbbaaacccaaacccaaaaaaaaaaaaacbbbbaaaaaaaaaaaaa
aaaaaaaajjjkjllljjjjjaaaaaaaaaaaaaaacabbbbbbacaaaacccmnonpaaaaacbbbcaaaaaaaaaaaaaaacccccaaaaaaaaaaaaa
aaaaaaaaqqqcclrlqqqqqbbbbbbbbbbbbbbbcaccccccacaaaacaaaacaaaabaacccccaaaaaaaaaaaaaaalaaacaaaaaaaaaaaaa
aaaaaaaaqqqcjlllqqqqqccccccccccccccccacabbbcacaaaacaaaacaaaasaaaacaaaaaaaaaaaaaaaaalbbbcaaaaaaaaaaaaa
aaaaaaaaqqqcqjjjqqqqqaaaaaaaaaaaaaabbbcacllcacaaaacaaaacbbbbtbbbbcaaaaaaaaaaaaaaaaacccccaaaaaaaaaaaaa
aaaaaaaaqqmnnnunnnpqqaaaaaaaabbbbbacllcacabbbcaaaacaaaacccccvcccccaaaaaaaaaaaaaaaaacaaaaaaaaaaaaaaaaa
aaaaaaaaqqjjjjcjjjjqqaaaaaaaajjjjjacabbbcaccccabbbcbbbaaaaaataaaaaaaaaaaaaaaaaaaaaacaaaaaaaaaaaaaaaaa
aaaaaaaaqqqqqqcqqqqqqaaaaaaaaqqqqqbcaccccajaakakdddddkaaaaaawaaaaaaaaaaaaaaaaaaaaaacaaaaaaaaaaaaaaaaa
aaaaaaaaqqqqqqcqqqqqqaaaaaaaaqqcccccacaaaaqaaaadddddddaaaaaacaaaaaaaaaaaaaaaaaaaaaacaaaaaaaaaaaaaaaaa
aaaaaaaaqqqqqccqqqqqqaaaaaaaaqqcjjaaacabbbqbbbbddjjjddbbbbbbcaaaaaaaaaaaaaaaaaaaaaacaaaaaaaaaaaaaaaaa
aaaaaaaaqqqqqcjqsqqqqaaaaaaaaqqcqqaaacakccccccxddqyqddcccccccaaaaaaaaaaaaaaaaaaaaaacbbbbbbaaaaaaaaaaa
aaaaaaaaqqqqkccctqqqqaaaaaaabbbcbbbaacbbcaaaaaaddqjqddaabdbaaaaaaaaaaaaaaaaaaaaaaaacccccccaaaaaaaaaaa
aaaaaaaaqqqqjjjjtqqqqaaaaaaamnnunnpaaccccaaaaaadddddddaadddaaaaaaaaaaaaabbbbbbbbbbbbbbabbcaaaaaaaaaaa
aaaaaaaaqqqqqqqqvqqqqaaaaaaabbbcbbbaaaaakaaaaaakdddddkaadzdaaaaaaaaaaaaaccccccccccccccacccaaaaaaaaaaa
aaaaaaaaqqqqqqqqtqqqqaaaaaaamnnonnpaaaaaaaaaaaaaasasbaaadddaaaaaaaaaaaaacaaaaaaaaaaaacacalaaaaaaaaaaa
aaaaaaaaqqqqkqqqtcqqqaaaaaaabbbcbbbaaaaaaaaaaaaaatatkaaaaaaaaaaaaaaaaaaacaaaaaaaaaabbcacblaaaaaaaaaaa
aaaaaaaaqqqqccccwjqqqaaaaaaamnnunnpaaaaaaaaaaaaaatbtaaaaaaaaaaaaaaaaaaaacaaaaaaaaaacccacccaaaaaaaaaaa
aaaaaaaaqqqqcjjjjqqqqaaaaaaaaaacaaaaaaaaaaaaaaaaatctaaaaaaaaaaaaaaaaaaaacaaaaaaaaaacacbbacaaaaaaaaaaa
aaaaaaaaqqqqcccqqqqqqaaaaaaaaaacaaaaaaaaaaaaaaaabtataaaaaaaaaaaaaaaabbbbcabbbaaaaaacacccacaaaaaaaaaaa
aaaaaaaaqqqqjjcqqqqqqaaabbbbbbbcaaaaaaaaaaaaaaaaktataaaaaaaaaaaaaaaasccccaccsaaaaaacaaacacaaaaaaaaaaa
aaaaaaaaqqmnnnunnnpqqaaajjjjccccaaaaaaaaaaaaaaaaatbtaaaaaaaaaaaaaaaataaaaaaataaaaaacaaacacaaaaaaaaaaa
aaaaaaaaqqjjjjcjjjjqqaaaqabacaaaaaaaaaaaaaaaaaaaavcAaaaaaaaaaaaaaaaataabbbaataaaaaacaaacacaaaaaaaaaaa
aaaaaaaaqqqqqqcqcccqqaaaqasacaaaaaaaaaaaaaaaaaaaatatbaaaaaaaaaaaaaaatbadddabtaaaaaacaaacacbbbaaaaaaaa
aaaaaaaaqqqqqqcqcjcqqbbbqbtbcaaaaaaaaaaaaaaaaaaaatatkaaaaaaaaaaaaaaavcadBdacvaaaaaacaaacaccccaaaaaaaa
aaaaaaaaqqqqqqcccqcqccccccvccaaaaaaaaaaaaaaaaaaaatbtaaaaaaaaaaaaaaaataadddaatbbbaaacaaalaaaalaaaaaaaa
aaaaaaaaqqqqqqjjjqcqcaaaaataaaaaaaaaaaaaaaaabaaaatctaaaaaaaaaaaaaaaataaadaaatcccaaacaaalbbbblaaaaaaaa
aaaaaaaaqqqqqqqqqqcccaaaaawaaaaaaaaaaaabbbbbkaaabtataaaaaaaaaaaaaaaatbbbdbbbtaacaaacaaaccccccaaaaaaaa
aaaaaaaaaaaaaaaaaaaaaaaaaaaaaaaaaaaaaaakcccccaaaktataaaaaaaaaaaaaaaawcccccccwaacaaacaaaaaaaaaaaaaaaaa
aaaaaaaaaaaaaaaaaaaaaaaaaaaaaaaaaaaaaaaacabbcaaabwbwbaaaaaaaaaaaaaaaaaaacaaaaaacbbbcaaaaaaaaaaaaaaaaa
aaaaaaaaaaaaaaaaaaaaaaaaaaaaaaaaaaaaaaaacacccaaakdddkaaaaaaaaaaaaaaaaaaacaaaaaacccccaaaaaaaaaaaaaaaaa
aaaaaaaaaaaaaaaaaaaaaaaaaaaaaaaaaaaaaaaalalabbbbdddddbbbbbbbbaaaaaaaaaaacaaaaaaaaaaaaaaaaaaaaaaaaaaaa
aaaaaaaaaaaaaaaaaaaaaaaaaaabbbbbbbbbbbaalalaccccddkddCcccccccaaaaaaaaaaacaaaaaaaaaaaaaaaaaaaaaaaaaaaa
aaaaaaaaaaaaaaaaaaaaaaaaaaajjjjjjjjjjjaalalbcaaadddddaaaabbbcbbbaaaaaaaacaaaaaaaaaaaaaaaaaaaaaaaaaaaa
aaaaaaaaaaaaaaaaaaaaaaaaaaaqqqqqqcccqqaacacccaaakdddkaaaamnnDnnpaaaaaaaacaaaaaaaaaaaaaaaaaaaaaaaaaaaa
aaaaaaaaaaaaaaaaaaaaaaaaaaaqccccqcjcqqaacbbbbbbaaaaaaaaaaabbcaaaaaaaaaaacaaaaaaaaaaaaaaaaaaaaaaaaaaaa
aaaaaaaaaaaaaaaaaaaaaaaaaaaqcjjcqcqcqqaacccccccaaaaaaaaaaacccaaaaaaabbbbcbbbbaaaaaaaaaaaaaaaaaaaaaaaa
aaaaaaaaaaaaaaaaaaaaaaaaaaalllqcqcqcqqbbbbbbbacbbbbbbbabbbcbbbaaaaaamnnnunnnpaaaaaaaaaaaaaaaaaaaaaaaa
aaaaaaaaaaaaaaaaaaaaaaaaaaalElqcqcqccccccccccacclllcckamnnFnnpaaaaaajjjjjjcjjaaaaaaaaaaaaaaaaaaaaaaaa
aaaaaaaaaaaaaaaaaaaaaaaaaaalllqcqcqjjjaaaaabcbbbbbbbcaaaaacbbaaaaaaamnnnonnnpaaaaaaaaaaaaaaaaaaaaaaaa
aaaaaaaaaaaaaaaaaaaaaaaaaaajjjqcqccccqaaaaakcccclllccaaaaacccaaaaaaajjcjjjjjjaaaaaaaaaaaaaaaaaaaaaaaa
aaaaaaaaaaaaaaaaaaaaaaaaaaaqqqqcqjjjcqaaaaaaaaaaaaaakaaaabbbcbbbaaaamnnnunnnpaaaaaaaaaaaaaaaaaaaaaaaa
aaaaaaaaaaaaaaaaaaaaaaaaaaaqqqqccccccqaaaaaaaaaaaaaaaaaaamnnDnnpaaaajjjjcjjjjaaaaaaaaaaaaaaaaaaaaaaaa
aaaaaaaaaaaaaaaaaaaaaaaaaaaqqqqjjjjjjqaaaaaaaaaaaaaaaaaaaabbcaaaaaaaqqqqcqqqqaaaaaaaaaaaaaaaaaaaaaaaa
aaaaaaaaaaaaaaaaaaaaaaaaaaaaaaaaaaaaaaaaaaaaaaaaaaaaaaaaaacccaaaaaaaqqqqcqqqqaaaaaaaaaaaaaaaaaaaaaaaa
aaaaaaaaaaaaaaaaaaaaaaaaaaaaaaaaaaaaaaaaaaaaaaaaaaaaaaabbbcbbbaaaaaaqqqccqqqqaaaaaaaaaaaaaaaaaaaaaaaa
aaaaaaaaaaaaaaaaaaaaaaaaaaaaaaaaaaaaaaaaaaaaaaaaaaaaaaamnnFnnpaaaaaaqqqcjqqqqaaaaaaaaaaaaaaaaaaaaaaaa
aaaaaaaaaaaaaaaaaaaaaaaaaaaaaaaaaaaaaaaaaaaaaaaaaaaaaaaaaacaaaaaaaaaqqqcccqqqaaaaaaaaaaaaaaaaaaaaaaaa
aaaaaaaaaaaaaaaaaaaaaaaaaaaaaaaaaaaaaaaaaaaaaaaaaaaaaaaabbcbbaaaaaaaqqqjjcqqqaaaaaaaaaaaaaaaaaaaaaaaa
aaaaaaaaaaaaaaaaaaaaaaaaaaaaaaaaaaaaaaaaaaaaaaaaaaaaaaaajjjjjaaaaaaaqqqqccqqqaaaaaaaaaaaaaaaaaaaaaaaa
aaaaaaaaaaaaaaaaaaaaaaaaaaaaaaaaaaaaaaaaaaaaaaaaaaaaaaaamnFnpaaaaaaaqqqqcjqqqaaaaaaaaaaaaaaaaaaaaaaaa
aaaaaaaaaaaaaaaaaaaaaaaaaaaaaaaaaaaaaaaaaaaaaaaaaaaaaaaajjjjjaaaaaaaqqqdddqqqaaaaaaaaaaaaaaaaaaaaaaaa
aaaaaaaaaaaaaaaaaaaaaaaaaaaaaaaaaaaaaaaaaaaaaaaaaaaaaaaamnDnpaaaaaaaqqqdGdqqqaaaaaaaaaaaaaaaaaaaaaaaa
aaaaaaaaaaaaaaaaaaaaaaaaaaaaaaaaaaaaaaaaaaaaaaaaaaaaaaaajjjjjaaaaaaaqqqdddqqqaaaaaaaaaaaaaaaaaaaaaaaa
aaaaaaaaaaaaaabbbbbbbbbbbbbbbbbbbbbbbbbaaaaaaaaaaaaaaaaamnFnpaaaaaaaaaaaaaaaaaaaaaaaaaaaaaaaaaaaaaaaa
aaaaaaaaaaaaaaHHHHHHHHHHHHHHHHHHHHHHHHHaaaaaaaaaaaaaaaaajjjjjaaaaaaaaaaaaaaaaaaaaaaaaaaaaaaaaaaaaaaaa
aaaaaaaaaaaaaaIIIIIIIIIIaaaadsssssJsssdabbbaaabbbbbbbaaamnDnpaaaaaaaaaaaaaaaaaaaaaaaaaaaaaaaaaaaaaaaa
aaaaaaaaaaaaaaIIIIIIIIIIaaaadtttttttttdbdddaaacccccccaaajjjjjaaaaaaaaaaaaaaaaaaaaaaaaaaaaaaaaaaaaaaaa
aaaaaaaaaaaaaaIIIIIIIIIIaaaadttttttKttdddLdaaacHHHHHcaaamnFnpaaaabbbbbaaaaaaaaaaaaaaaaaaaaaaaaaaaaaaa
aaaaaaaaaaaaaaIIIIIIIIIIaaaadtttttttttdadddaaacIIIIIcaaajjjjjaaaaHHHHHaaaaaaaaaaaaaaaaaaaaaaaaaaaaaaa
aaaaaaaaaaaaaakdkIIIIIIIbbbbdttKttttttdbbbaaaacIIIIIcbbbbkdkbbbbbIIIIIaaaaaaaaaaaaaaaaaaaaaaaaaaaaaaa
aaaaaaaaaaaaaadMdlllcIIIcllldtNttKttNtdcccaaaacIIIIIcccccdddcccccIIIIIaaaaaaaaaaaaaaaaaaaaaaaaaaaaaaa
aaaaaaaaaaaaaakdkHHHcIIIcaaadKttttttttdaacaaaacIIIIIaaaaakdkaaaaaIIIIIaaaaaaaaaaaaaaaaaaaaaaaaaaaaaaa
aaaaaaaaaaaaaaHHHIIIcIIIcaaadtttttttttdaacbbbbcbbbaaaaaaaaaaaaaaaIIIIIaaaaaaaaaaaaaaaaaaaaaaaaaaaaaaa
aaaaaaaaaaaaaaIIIIIIclllcaaadttttttttKdaacccccccccaaaaaaaaaaaaaaaaIIIaaaaaaaaaaaaaaaaaaaaaaaaaaaaaaaa
aaaaaaaaaaaaaaIIIIIIHHHHaaaadtttttttttdaaaaaaaaaacaaaaaaaaaaaaaaaamDpaaaaaaaaaaaaaaaaaaaaaaaaaaaaaaaa
aaaaaaaaaaaaaaIIIIIIIIIIbbbbdwwwOwwwwwdaaaaaaaaaacaaaaaaaaaaaaaaaaHHHaaaaaaaaaaaaaaaaaaaaaaaaaaaaaaaa
aaaaaaaaaaaaaaIIIIIIIIIIHHHHHHHHHHHHHHHaaaaaaaaaacaaaaaaaaaaaaaaaamFpaaaaaaaaaaaaaaaaaaaaaaaaaaaaaaaa
aaaaaaaaaaaaaaaaaaaaaaaaaaaaaaaaaaaaaaaaaaaaaaaaacaaaaaaaaaaaaaaaaHHHaaaaaaaaaaaaaaaaaaaaaaaaaaaaaaaa
aaaaaaaaaaaaaaaaaaaaaaaaaaaaaaaaaaaaaaaaaaaaaabbbcaaaaaaaaaaaaaaaamDpaaaaaaaaaaaaaaaaaaaaaaaaaaaaaaaa
aaaaaaaaaaaaaaaaaaaaaaaaaaaaaaaaaaaaaaaaaaaaaacllcaaaaaaaaaaaaaaabHHHbaaaaaaaaaaaaaaaaaaaaaaaaaaaaaaa
aaaaaaaaaaaaaaaaaaaaaaaaaaaaaaaaaaaaaaaaaaaabbcaaaaaaaaaaaaaaaaaaHIIIHaaaaaaaaaaaaaaaaaaaaaaaaaaaaaaa
aaaaaaaaaaaaaaaaaaaaaaaaaaaaaaaaaaaaaaaaaaaacccaaaaaaaaaaaaaaaaaaIdddIaaaaaaaaaaaaaaaaaaaaaaaaaaaaaaa
aaaaaaaaaaaaaaaaaaaaaaaaaaaaaaaaaaaaaaaaaaaalakaaaaaaaaaaaaaaaaaaIdPdIaaaaaaaaaaaaaaaaaaaaaaaaaaaaaaa
aaaaaaaaaaaaaaaaaaaaaaaaaaaaaaaaaaaaaaaaaaaalbbbaaaaaaaaaaaaaaaaaIdddIaaaaaaaaaaaaaaaaaaaaaaaaaaaaaaa
aaaaaaaaaaaaaaaaaaaaaaaaaaaaaaaaaaaaaaaaaaaaccckaaaaaaaaaaaaaaaaaIHHHIaaaaaaaaaaaaaaaaaaaaaaaaaaaaaaa
aaaaaaaaaaaaaaaaaaaaaaaaaaaaaaaaaaaaaaaaaaaaaalaaaaaaaaaaaaaaaaaaaaaaaaaaaaaaaaaaaaaaaaaaaaaaaaaaaaaa
aaaaaaaaaaaaaaaaaaaaaaaaaaaaaaaaaaaaaaaaaaabbblaaaaaaaaaaaaaaaaaaaaaaaaaaaaaaaaaaaaaaaaaaaaaaaaaaaaaa
aaaaaaaaaaaaaaaaaaaaaaaaaaaaaaaaaaaaaaaaaaakcccaaaaaaaaaaaaaaaaaaaaaaaaaaaaaaaaaaaaaaaaaaaaaaaaaaaaaa
aaaaaaaaaaaaaaaaaaaaaaaaaaaaaaaaaaaaaaaaaaaalaaaaaaaaaaaaaaaaaaaaaaaaaaaaaaaaaaaaaaaaaaaaaaaaaaaaaaaa
aaaaaaaaaaaaaaaaaaaaaaaaaaaaaaaaaaaaaaaaaaaalaaaaaaaaaaaaaaaaaaaaaaaaaaaaaaaaaaaaaaaaaaaaaaaaaaaaaaaa
aaaaaaaaaaaaaaaaaaaaaaaaaaaaaaaaaaaaaaaaabbbQbbbaaaaaaaaaaaaaaaaaaaaaaaaaaaaaaaaaaaaaaaaaaaaaaaaaaaaa
aaaaaaaaaaaaaaaaaaaaaaaaaaaaaaaaaaaaaaaaajjjjjjjaaaaaaaaaaaaaaaaaaaaaaaaaaaaaaaaaaaaaaaaaaaaaaaaaaaaa
aaaaaaaaaaaaaaaaaaaaaaaaaaaaaaaaaaaaaaaaaqqqqqqqaaaaaaaaaaaaaaaaaaaaaaaaaaaaaaaaaaaaaaaaaaaaaaaaaaaaa
aaaaaaaaaaaaaaaaaaaaaaaaaaaaaaaaaaaaaaaaaqqdddqqaaaaaaaaaaaaaaaaaaaaaaaaaaaaaaaaaaaaaaaaaaaaaaaaaaaaa
aaaaaaaaaaaaaaaaaaaaaaaaaaaaaaaaaaaaaaaaaqqdRdqqaaaaaaaaaaaaaaaaaaaaaaaaaaaaaaaaaaaaaaaaaaaaaaaaaaaaa
aaaaaaaaaaaaaaaaaaaaaaaaaaaaaaaaaaaaaaaaaqqdddqqaaaaaaaaaaaaaaaaaaaaaaaaaaaaaaaaaaaaaaaaaaaaaaaaaaaaa
aaaaaaaaaaaaaaaaaaaaaaaaaaaaaaaaaaaaaaaaaqqjjjqqaaaaaaaaaaaaaaaaaaaaaaaaaaaaaaaaaaaaaaaaaaaaaaaaaaaaa
aaaaaaaaaaaaaaaaaaaaaaaaaaaaaaaaaaaaaaaaaqqqqqqqaaaaaaaaaaaaaaaaaaaaaaaaaaaaaaaaaaaaaaaaaaaaaaaaaaaaa
aaaaaaaaaaaaaaaaaaaaaaaaaaaaaaaaaaaaaaaaaaaaaaaaaaaaaaaaaaaaaaaaaaaaaaaaaaaaaaaaaaaaaaaaaaaaaaaaaaaaa
aaaaaaaaaaaaaaaaaaaaaaaaaaaaaaaaaaaaaaaaaaaaaaaaaaaaaaaaaaaaaaaaaaaaaaaaaaaaaaaaaaaaaaaaaaaaaaaaaaaaa
aaaaaaaaaaaaaaaaaaaaaaaaaaaaaaaaaaaaaaaaaaaaaaaaaaaaaaaaaaaaaaaaaaaaaaaaaaaaaaaaaaaaaaaaaaaaaaaaaaaaa
aaaaaaaaaaaaaaaaaaaaaaaaaaaaaaaaaaaaaaaaaaaaaaaaaaaaaaaaaaaaaaaaaaaaaaaaaaaaaaaaaaaaaaaaaaaaaaaaaaaaa
aaaaaaaaaaaaaaaaaaaaaaaaaaaaaaaaaaaaaaaaaaaaaaaaaaaaaaaaaaaaaaaaaaaaaaaaaaaaaaaaaaaaaaaaaaaaaaaaaaaaa
aaaaaaaaaaaaaaaaaaaaaaaaaaaaaaaaaaaaaaaaaaaaaaaaaaaaaaaaaaaaaaaaaaaaaaaaaaaaaaaaaaaaaaaaaaaaaaaaaaaaa
aaaaaaaaaaaaaaaaaaaaaaaaaaaaaaaaaaaaaaaaaaaaaaaaaaaaaaaaaaaaaaaaaaaaaaaaaaaaaaaaaaaaaaaaaaaaaaaaaaaaa
"}
