"a" = (/turf/wall,/area/map)
"b" = (/turf/wall{icon_state = "wall-edge"},/area/map)
"c" = (/obj/item/orb,/turf/floor,/area/map)
"d" = (/turf/floor,/area/map)
"e" = (/turf/checkpoint/start,/area/map)
"f" = (/obj/door/blue,/turf/floor,/area/map)
"g" = (/turf/pit{icon_state = "floor-edge"},/area/map/pit)
"h" = (/obj/trap/spear,/turf/floor,/area/map)
"i" = (/obj/trap/spike,/turf/floor,/area/map)
"j" = (/obj/trap/blade_trail,/turf/floor{icon_state = "floor-hl"},/area/map)
"k" = (/obj/trap/blade_trail,/turf/floor{icon_state = "floor-h"},/area/map)
"l" = (/obj/trap/blade_trail,/obj/trap/blade{dir = 4},/turf/floor{icon_state = "floor-h"},/area/map)
"m" = (/obj/trap/blade_trail,/turf/floor{icon_state = "floor-hr"},/area/map)
"n" = (/turf/pit,/area/map/pit)
"o" = (/obj/item/talaria,/turf/floor,/area/map)
"p" = (/obj/trap/blade_trail,/turf/floor{icon_state = "floor-vt"},/area/map)
"q" = (/obj/trap/blade_trail,/turf/floor{icon_state = "floor-v"},/area/map)
"r" = (/obj/trap/blade_trail,/obj/trap/blade{dir = 8},/turf/floor{icon_state = "floor-h"},/area/map)
"s" = (/obj/trap/blade_trail,/obj/trap/blade,/turf/floor{icon_state = "floor-v"},/area/map)
"t" = (/obj/trap/blade_trail,/turf/floor{icon_state = "floor-vb"},/area/map)
"u" = (/obj/trap/blade_trail,/turf/floor,/area/map)
"v" = (/obj/door/yellow,/turf/floor,/area/map)
"w" = (/obj/item/key/red,/turf/floor,/area/map)
"x" = (/obj/trap/blade_trail,/obj/trap/blade,/turf/floor,/area/map)
"y" = (/turf/checkpoint/yellow_zone,/area/map)
"z" = (/obj/trap/blade_trail,/obj/trap/blade{dir = 1},/turf/floor{icon_state = "floor-v"},/area/map)
"A" = (/turf/checkpoint/blue_zone,/area/map)
"B" = (/obj/door/red,/turf/floor,/area/map)
"C" = (/obj/trap/blade_trail,/obj/trap/blade{dir = 8; speed = 4},/turf/floor{icon_state = "floor-h"},/area/map)
"D" = (/obj/item/key/yellow,/turf/floor,/area/map)
"E" = (/obj/trap/blade_trail,/obj/trap/blade{dir = 4; speed = 4},/turf/floor{icon_state = "floor-h"},/area/map)
"F" = (/obj/item/key/blue,/turf/floor,/area/map)
"G" = (/turf/water{icon_state = "water-edge"},/area/map/water)
"H" = (/turf/water,/area/map/water)
"I" = (/obj/trap/blade_trail,/obj/trap/blade{dir = 1; speed = 4},/turf/floor{icon_state = "floor-vt"},/area/map)
"J" = (/obj/trap/blade_trail,/obj/trap/blade{speed = 4},/turf/floor{icon_state = "floor-v"},/area/map)
"K" = (/turf/checkpoint/green_zone,/area/map)
"L" = (/obj/item/snorkel,/turf/floor,/area/map)
"M" = (/obj/trap/blade_trail,/obj/trap/blade{dir = 1; speed = 4},/turf/floor{icon_state = "floor-v"},/area/map)
"N" = (/obj/trap/blade_trail,/obj/trap/blade{dir = 1; speed = 4},/turf/floor{icon_state = "floor-vb"},/area/map)
"O" = (/obj/item/key/green,/turf/floor,/area/map)
"P" = (/obj/door/green,/turf/floor,/area/map)
"Q" = (/turf/flag,/area/map)

(1,1,1) = {"
aaaaaaaaaaaaaaaaaaaaaaaaaaaaaaaaaaaaaaaaaaaaaaaaaaaaaaaaaaaaaaaaaaaaaaaaaaaaaaaaaaaaaaaaaaaaaaaaaaaaa
aaaaaaaaaaaaaaaaaaaaaaaaaaaaaaaaaaaaaaaaaaaaaaaaaaaaaaaaaaaaaaaaaaaaaaaaaaaaaaaaaaaaaaaaaaaaaaaaaaaaa
aaaaaaaaaaaaaaaaaaaaaaaaaaaaaaaaaaaaaaaaaaaaaaaaaaaaaaaaaaaaaaaaaaaaaaaaaaaaaaaaaaaaaaaaaaaaaaaaaaaaa
aaaaaaaaaaaaaaaaaaaaaaaaaaaaaaaaaaaaaaaaaaaaaaaaaaaaaaaaaaaaaaaaaaaaaaaaaaaaaaaaaaaaaaaaaaaaaaaaaaaaa
aaaaaaaaaaaaaaaaaaaaaaaaaaaaaaaaaaaaaaaaaaaaaaaaaaaaaaaaaaaaaaaaaaaaaaaaaaaaaaaaaaaaaaaaaaaaaaaaaaaaa
aaaaaaaaaaaaaaaaaaaaaaaaaaaaaaaaaaaaaaaaaaaaaaaaaaaaaaaaaaaaaaaaaaaaaaaaaaaaaaaaaaaaaaaaaaaaaaaaaaaaa
aaaaaaaaaaaaaaaaaaaaaaaaaaaaaaaaaaaaaaaaaaaaaaaaaaaaaaaaaaaabbbbbbaaaaaaaaaaaaaaaaaaaaaaaaaaaaaaaaaaa
aaaaaaaaaaaaaaaaaaaaaaaaaaaaaaaaaaaaaaaaaaaaaaaaaaaaaaaaaaaaccccccaaaaaaaaaaaaaaabbbaaaaaaaaaaaaaaaaa
aaaaaaaaaaaaaaaaaaaaaaaaaaaaaaaaaaaaaaaaaaaaaaaaaaaaaaaaaabbcaaaacaaaaaaaaaaaaaaadddaaaaaaaaaaaaaaaaa
aaaaaaaaaaaaaaaaaaaaaaaaaaaaaaaaaaaaaaaaaaaaaaaaaaaaaaaaaacccaabbcbbaaaaaaaaaaaaadedaaaaaaaaaaaaaaaaa
aaaaaaaaaaaaaaaaaaaaaaaaaaaaaaaaaaaaaaaaaaaaaaaaaaaaaaaaaacaaaacccccaaaaaaaaaaaaadddaaaaaaaaaaaaaaaaa
aaaaaaaaaaaaaaaaaaaaaaaaaaaaaaaaaaaaaaaaaaaaaaaaaaaaaaabbbcaabbcaaacbbaaaaaaaaaaaacaaaaaaaaaaaaaaaaaa
aaaaaaaaaaaaaaaaaaaaaaaaaaaaaaaaaaaaaaaaaaaaaaaaaaaaaaaccccaacccaaacccaaaaaaaaaaaacaaaaaaaaaaaaaaaaaa
aaaaaaaaaaaaaaaaaaaaaaaaaaaaaaaaaaaaaaaaaaaaaaaaaaaaaaacaacbbcaaaaaaacbbbbbbbbbbbbcbaaaaaaaaaaaaaaaaa
aaaaaaaaaaaaaaaaaaaaaaaaaaaaaaaaaaaaaaaaaaaaaaaaaaaaaaacaaccccaaaaaaaccccccccccccfccaaaaaaaaaaaaaaaaa
aaaaaaaaaaaaaaaaaaaaaaaaaaaaaaaaaaaabbbbbbbbbbaaaaaaaaacaaaaacbbaaabbcaaaaaaaaaaaaacaaaaaaaaaaaaaaaaa
aaaaaaaabbbbbbbbbbbbbaaaaaaaaaaaaaaaccccccccccaaaabbbbbcbbaaacccaaacccaaaaaaaaaaaaacbbbbaaaaaaaaaaaaa
aaaaaaaaggghgiiigggggaaaaaaaaaaaaaaacabbbbbbacaaaacccjklkmaaaaacbbbcaaaaaaaaaaaaaaacccccaaaaaaaaaaaaa
aaaaaaaannnccioinnnnnbbbbbbbbbbbbbbbcaccccccacaaaacaaaacaaaabaacccccaaaaaaaaaaaaaaaiaaacaaaaaaaaaaaaa
aaaaaaaannncgiiinnnnnccccccccccccccccacabbbcacaaaacaaaacaaaapaaaacaaaaaaaaaaaaaaaaaibbbcaaaaaaaaaaaaa
aaaaaaaannncngggnnnnnaaaaaaaaaaaaaabbbcaciicacaaaacaaaacbbbbqbbbbcaaaaaaaaaaaaaaaaacccccaaaaaaaaaaaaa
aaaaaaaannjkkkrkkkmnnaaaaaaaabbbbbaciicacabbbcaaaacaaaacccccscccccaaaaaaaaaaaaaaaaacaaaaaaaaaaaaaaaaa
aaaaaaaannggggcggggnnaaaaaaaagggggacabbbcaccccabbbcbbbaaaaaaqaaaaaaaaaaaaaaaaaaaaaacaaaaaaaaaaaaaaaaa
aaaaaaaannnnnncnnnnnnaaaaaaaannnnnbcaccccagaahahdddddhaaaaaataaaaaaaaaaaaaaaaaaaaaacaaaaaaaaaaaaaaaaa
aaaaaaaannnnnncnnnnnnaaaaaaaanncccccacaaaanaaaadddddddaaaaaacaaaaaaaaaaaaaaaaaaaaaacaaaaaaaaaaaaaaaaa
aaaaaaaannnnnccnnnnnnaaaaaaaanncggaaacabbbnbbbbddgggddbbbbbbcaaaaaaaaaaaaaaaaaaaaaacaaaaaaaaaaaaaaaaa
aaaaaaaannnnncgnunnnnaaaaaaaanncnnaaacahccccccvddnwnddcccccccaaaaaaaaaaaaaaaaaaaaaacbbbbbbaaaaaaaaaaa
aaaaaaaannnnhcccunnnnaaaaaaabbbcbbbaacbbcaaaaaaddngnddaabdbaaaaaaaaaaaaaaaaaaaaaaaacccccccaaaaaaaaaaa
aaaaaaaannnnggggunnnnaaaaaaajkkrkkmaaccccaaaaaadddddddaadddaaaaaaaaaaaaabbbbbbbbbbbbbbabbcaaaaaaaaaaa
aaaaaaaannnnnnnnxnnnnaaaaaaabbbcbbbaaaaahaaaaaahdddddhaadydaaaaaaaaaaaaaccccccccccccccacccaaaaaaaaaaa
aaaaaaaannnnnnnnunnnnaaaaaaajkklkkmaaaaaaaaaaaaaapapbaaadddaaaaaaaaaaaaacaaaaaaaaaaaacacaiaaaaaaaaaaa
aaaaaaaannnnhnnnucnnnaaaaaaabbbcbbbaaaaaaaaaaaaaaqaqhaaaaaaaaaaaaaaaaaaacaaaaaaaaaabbcacbiaaaaaaaaaaa
aaaaaaaannnnccccugnnnaaaaaaajkkrkkmaaaaaaaaaaaaaaqbqaaaaaaaaaaaaaaaaaaaacaaaaaaaaaacccacccaaaaaaaaaaa
aaaaaaaannnncggggnnnnaaaaaaaaaacaaaaaaaaaaaaaaaaaqcqaaaaaaaaaaaaaaaaaaaacaaaaaaaaaacacbbacaaaaaaaaaaa
aaaaaaaannnncccnnnnnnaaaaaaaaaacaaaaaaaaaaaaaaaabqaqaaaaaaaaaaaaaaaabbbbcabbbaaaaaacacccacaaaaaaaaaaa
aaaaaaaannnnggcnnnnnnaaabbbbbbbcaaaaaaaaaaaaaaaahqaqaaaaaaaaaaaaaaaapccccaccpaaaaaacaaacacaaaaaaaaaaa
aaaaaaaannjkkkrkkkmnnaaaggggccccaaaaaaaaaaaaaaaaaqbqaaaaaaaaaaaaaaaaqaaaaaaaqaaaaaacaaacacaaaaaaaaaaa
aaaaaaaannggggcggggnnaaanabacaaaaaaaaaaaaaaaaaaaasczaaaaaaaaaaaaaaaaqaabbbaaqaaaaaacaaacacaaaaaaaaaaa
aaaaaaaannnnnncncccnnaaanapacaaaaaaaaaaaaaaaaaaaaqaqbaaaaaaaaaaaaaaaqbadddabqaaaaaacaaacacbbbaaaaaaaa
aaaaaaaannnnnncncgcnnbbbnbqbcaaaaaaaaaaaaaaaaaaaaqaqhaaaaaaaaaaaaaaascadAdacsaaaaaacaaacaccccaaaaaaaa
aaaaaaaannnnnncccncnccccccsccaaaaaaaaaaaaaaaaaaaaqbqaaaaaaaaaaaaaaaaqaadddaaqbbbaaacaaaiaaaaiaaaaaaaa
aaaaaaaannnnnngggncncaaaaaqaaaaaaaaaaaaaaaaabaaaaqcqaaaaaaaaaaaaaaaaqaaadaaaqcccaaacaaaibbbbiaaaaaaaa
aaaaaaaannnnnnnnnncccaaaaataaaaaaaaaaaabbbbbhaaabqaqaaaaaaaaaaaaaaaaqbbbdbbbqaacaaacaaaccccccaaaaaaaa
aaaaaaaaaaaaaaaaaaaaaaaaaaaaaaaaaaaaaaahcccccaaahqaqaaaaaaaaaaaaaaaatccccccctaacaaacaaaaaaaaaaaaaaaaa
aaaaaaaaaaaaaaaaaaaaaaaaaaaaaaaaaaaaaaaacabbcaaabtbtbaaaaaaaaaaaaaaaaaaacaaaaaacbbbcaaaaaaaaaaaaaaaaa
aaaaaaaaaaaaaaaaaaaaaaaaaaaaaaaaaaaaaaaacacccaaahdddhaaaaaaaaaaaaaaaaaaacaaaaaacccccaaaaaaaaaaaaaaaaa
aaaaaaaaaaaaaaaaaaaaaaaaaaaaaaaaaaaaaaaaiaiabbbbdddddbbbbbbbbaaaaaaaaaaacaaaaaaaaaaaaaaaaaaaaaaaaaaaa
aaaaaaaaaaaaaaaaaaaaaaaaaaaaaaaaaaaaaaaaiaiaccccddhddBcccccccaaaaaaaaaaacaaaaaaaaaaaaaaaaaaaaaaaaaaaa
aaaaaaaaaaaaaaaaaaaaaaaaaaagggggggggggaaiaibcaaadddddaaaabbbcbbbaaaaaaaacaaaaaaaaaaaaaaaaaaaaaaaaaaaa
aaaaaaaaaaaaaaaaaaaaaaaaaaannnnnncccnnaacacccaaahdddhaaaajkkCkkmaaaaaaaacaaaaaaaaaaaaaaaaaaaaaaaaaaaa
aaaaaaaaaaaaaaaaaaaaaaaaaaanccccncgcnnaacbbbbbbaaaaaaaaaaabbcaaaaaaaaaaacaaaaaaaaaaaaaaaaaaaaaaaaaaaa
aaaaaaaaaaaaaaaaaaaaaaaaaaancggcncncnnaacccccccaaaaaaaaaaacccaaaaaaabbbbcbbbbaaaaaaaaaaaaaaaaaaaaaaaa
aaaaaaaaaaaaaaaaaaaaaaaaaaaiiincncncnnbbbbbbbacbbbbbbbabbbcbbbaaaaaajkkkrkkkmaaaaaaaaaaaaaaaaaaaaaaaa
aaaaaaaaaaaaaaaaaaaaaaaaaaaiDincncnccccccccccacciiicchajkkEkkmaaaaaaggggggcggaaaaaaaaaaaaaaaaaaaaaaaa
aaaaaaaaaaaaaaaaaaaaaaaaaaaiiincncngggaaaaabcbbbbbbbcaaaaacbbaaaaaaajkkklkkkmaaaaaaaaaaaaaaaaaaaaaaaa
aaaaaaaaaaaaaaaaaaaaaaaaaaagggncnccccnaaaaahcccciiiccaaaaacccaaaaaaaggcggggggaaaaaaaaaaaaaaaaaaaaaaaa
aaaaaaaaaaaaaaaaaaaaaaaaaaannnncngggcnaaaaaaaaaaaaaahaaaabbbcbbbaaaajkkkrkkkmaaaaaaaaaaaaaaaaaaaaaaaa
aaaaaaaaaaaaaaaaaaaaaaaaaaannnnccccccnaaaaaaaaaaaaaaaaaaajkkCkkmaaaaggggcggggaaaaaaaaaaaaaaaaaaaaaaaa
aaaaaaaaaaaaaaaaaaaaaaaaaaannnnggggggnaaaaaaaaaaaaaaaaaaaabbcaaaaaaannnncnnnnaaaaaaaaaaaaaaaaaaaaaaaa
aaaaaaaaaaaaaaaaaaaaaaaaaaaaaaaaaaaaaaaaaaaaaaaaaaaaaaaaaacccaaaaaaannnncnnnnaaaaaaaaaaaaaaaaaaaaaaaa
aaaaaaaaaaaaaaaaaaaaaaaaaaaaaaaaaaaaaaaaaaaaaaaaaaaaaaabbbcbbbaaaaaannnccnnnnaaaaaaaaaaaaaaaaaaaaaaaa
aaaaaaaaaaaaaaaaaaaaaaaaaaaaaaaaaaaaaaaaaaaaaaaaaaaaaaajkkEkkmaaaaaannncgnnnnaaaaaaaaaaaaaaaaaaaaaaaa
aaaaaaaaaaaaaaaaaaaaaaaaaaaaaaaaaaaaaaaaaaaaaaaaaaaaaaaaaacaaaaaaaaannncccnnnaaaaaaaaaaaaaaaaaaaaaaaa
aaaaaaaaaaaaaaaaaaaaaaaaaaaaaaaaaaaaaaaaaaaaaaaaaaaaaaaabbcbbaaaaaaannnggcnnnaaaaaaaaaaaaaaaaaaaaaaaa
aaaaaaaaaaaaaaaaaaaaaaaaaaaaaaaaaaaaaaaaaaaaaaaaaaaaaaaagggggaaaaaaannnnccnnnaaaaaaaaaaaaaaaaaaaaaaaa
aaaaaaaaaaaaaaaaaaaaaaaaaaaaaaaaaaaaaaaaaaaaaaaaaaaaaaaajkEkmaaaaaaannnncgnnnaaaaaaaaaaaaaaaaaaaaaaaa
aaaaaaaaaaaaaaaaaaaaaaaaaaaaaaaaaaaaaaaaaaaaaaaaaaaaaaaagggggaaaaaaannndddnnnaaaaaaaaaaaaaaaaaaaaaaaa
aaaaaaaaaaaaaaaaaaaaaaaaaaaaaaaaaaaaaaaaaaaaaaaaaaaaaaaajkCkmaaaaaaannndFdnnnaaaaaaaaaaaaaaaaaaaaaaaa
aaaaaaaaaaaaaaaaaaaaaaaaaaaaaaaaaaaaaaaaaaaaaaaaaaaaaaaagggggaaaaaaannndddnnnaaaaaaaaaaaaaaaaaaaaaaaa
aaaaaaaaaaaaaabbbbbbbbbbbbbbbbbbbbbbbbbaaaaaaaaaaaaaaaaajkEkmaaaaaaaaaaaaaaaaaaaaaaaaaaaaaaaaaaaaaaaa
aaaaaaaaaaaaaaGGGGGGGGGGGGGGGGGGGGGGGGGaaaaaaaaaaaaaaaaagggggaaaaaaaaaaaaaaaaaaaaaaaaaaaaaaaaaaaaaaaa
aaaaaaaaaaaaaaHHHHHHHHHHaaaadpppppIpppdabbbaaabbbbbbbaaajkCkmaaaaaaaaaaaaaaaaaaaaaaaaaaaaaaaaaaaaaaaa
aaaaaaaaaaaaaaHHHHHHHHHHaaaadqqqqqqqqqdbdddaaacccccccaaagggggaaaaaaaaaaaaaaaaaaaaaaaaaaaaaaaaaaaaaaaa
aaaaaaaaaaaaaaHHHHHHHHHHaaaadqqqqqqJqqdddKdaaacGGGGGcaaajkEkmaaaabbbbbaaaaaaaaaaaaaaaaaaaaaaaaaaaaaaa
aaaaaaaaaaaaaaHHHHHHHHHHaaaadqqqqqqqqqdadddaaacHHHHHcaaagggggaaaaHHHHHaaaaaaaaaaaaaaaaaaaaaaaaaaaaaaa
aaaaaaaaaaaaaahdhHHHHHHHbbbbdqqJqqqqqqdbbbaaaacHHHHHcbbbbhdhbbbbbHHHHHaaaaaaaaaaaaaaaaaaaaaaaaaaaaaaa
aaaaaaaaaaaaaadLdiiicHHHciiidqMqqJqqMqdcccaaaacHHHHHcccccdddcccccHHHHHaaaaaaaaaaaaaaaaaaaaaaaaaaaaaaa
aaaaaaaaaaaaaahdhGGGcHHHcaaadJqqqqqqqqdaacaaaacHHHHHaaaaahdhaaaaaHHHHHaaaaaaaaaaaaaaaaaaaaaaaaaaaaaaa
aaaaaaaaaaaaaaGGGHHHcHHHcaaadqqqqqqqqqdaacbbbbcbbbaaaaaaaaaaaaaaaHHHHHaaaaaaaaaaaaaaaaaaaaaaaaaaaaaaa
aaaaaaaaaaaaaaHHHHHHciiicaaadqqqqqqqqJdaacccccccccaaaaaaaaaaaaaaaaHHHaaaaaaaaaaaaaaaaaaaaaaaaaaaaaaaa
aaaaaaaaaaaaaaHHHHHHGGGGaaaadqqqqqqqqqdaaaaaaaaaacaaaaaaaaaaaaaaaajCmaaaaaaaaaaaaaaaaaaaaaaaaaaaaaaaa
aaaaaaaaaaaaaaHHHHHHHHHHbbbbdtttNtttttdaaaaaaaaaacaaaaaaaaaaaaaaaaGGGaaaaaaaaaaaaaaaaaaaaaaaaaaaaaaaa
aaaaaaaaaaaaaaHHHHHHHHHHGGGGGGGGGGGGGGGaaaaaaaaaacaaaaaaaaaaaaaaaajEmaaaaaaaaaaaaaaaaaaaaaaaaaaaaaaaa
aaaaaaaaaaaaaaaaaaaaaaaaaaaaaaaaaaaaaaaaaaaaaaaaacaaaaaaaaaaaaaaaaGGGaaaaaaaaaaaaaaaaaaaaaaaaaaaaaaaa
aaaaaaaaaaaaaaaaaaaaaaaaaaaaaaaaaaaaaaaaaaaaaabbbcaaaaaaaaaaaaaaaajCmaaaaaaaaaaaaaaaaaaaaaaaaaaaaaaaa
aaaaaaaaaaaaaaaaaaaaaaaaaaaaaaaaaaaaaaaaaaaaaaciicaaaaaaaaaaaaaaaaGGGaaaaaaaaaaaaaaaaaaaaaaaaaaaaaaaa
aaaaaaaaaaaaaaaaaaaaaaaaaaaaaaaaaaaaaaaaaaaabbcaaaaaaaaaaaaaaaaaaGHHHGaaaaaaaaaaaaaaaaaaaaaaaaaaaaaaa
aaaaaaaaaaaaaaaaaaaaaaaaaaaaaaaaaaaaaaaaaaaacccaaaaaaaaaaaaaaaaaaHdddHaaaaaaaaaaaaaaaaaaaaaaaaaaaaaaa
aaaaaaaaaaaaaaaaaaaaaaaaaaaaaaaaaaaaaaaaaaaaiahaaaaaaaaaaaaaaaaaaHdOdHaaaaaaaaaaaaaaaaaaaaaaaaaaaaaaa
aaaaaaaaaaaaaaaaaaaaaaaaaaaaaaaaaaaaaaaaaaaaibbbaaaaaaaaaaaaaaaaaHdddHaaaaaaaaaaaaaaaaaaaaaaaaaaaaaaa
aaaaaaaaaaaaaaaaaaaaaaaaaaaaaaaaaaaaaaaaaaaaccchaaaaaaaaaaaaaaaaaHGGGHaaaaaaaaaaaaaaaaaaaaaaaaaaaaaaa
aaaaaaaaaaaaaaaaaaaaaaaaaaaaaaaaaaaaaaaaaaaaaaiaaaaaaaaaaaaaaaaaaaaaaaaaaaaaaaaaaaaaaaaaaaaaaaaaaaaaa
aaaaaaaaaaaaaaaaaaaaaaaaaaaaaaaaaaaaaaaaaaabbbiaaaaaaaaaaaaaaaaaaaaaaaaaaaaaaaaaaaaaaaaaaaaaaaaaaaaaa
aaaaaaaaaaaaaaaaaaaaaaaaaaaaaaaaaaaaaaaaaaahcccaaaaaaaaaaaaaaaaaaaaaaaaaaaaaaaaaaaaaaaaaaaaaaaaaaaaaa
aaaaaaaaaaaaaaaaaaaaaaaaaaaaaaaaaaaaaaaaaaaaiaaaaaaaaaaaaaaaaaaaaaaaaaaaaaaaaaaaaaaaaaaaaaaaaaaaaaaaa
aaaaaaaaaaaaaaaaaaaaaaaaaaaaaaaaaaaaaaaaaaaaiaaaaaaaaaaaaaaaaaaaaaaaaaaaaaaaaaaaaaaaaaaaaaaaaaaaaaaaa
aaaaaaaaaaaaaaaaaaaaaaaaaaaaaaaaaaaaaaaaabbbPbbbaaaaaaaaaaaaaaaaaaaaaaaaaaaaaaaaaaaaaaaaaaaaaaaaaaaaa
aaaaaaaaaaaaaaaaaaaaaaaaaaaaaaaaaaaaaaaaagggggggaaaaaaaaaaaaaaaaaaaaaaaaaaaaaaaaaaaaaaaaaaaaaaaaaaaaa
aaaaaaaaaaaaaaaaaaaaaaaaaaaaaaaaaaaaaaaaannnnnnnaaaaaaaaaaaaaaaaaaaaaaaaaaaaaaaaaaaaaaaaaaaaaaaaaaaaa
aaaaaaaaaaaaaaaaaaaaaaaaaaaaaaaaaaaaaaaaanndddnnaaaaaaaaaaaaaaaaaaaaaaaaaaaaaaaaaaaaaaaaaaaaaaaaaaaaa
aaaaaaaaaaaaaaaaaaaaaaaaaaaaaaaaaaaaaaaaanndQdnnaaaaaaaaaaaaaaaaaaaaaaaaaaaaaaaaaaaaaaaaaaaaaaaaaaaaa
aaaaaaaaaaaaaaaaaaaaaaaaaaaaaaaaaaaaaaaaanndddnnaaaaaaaaaaaaaaaaaaaaaaaaaaaaaaaaaaaaaaaaaaaaaaaaaaaaa
aaaaaaaaaaaaaaaaaaaaaaaaaaaaaaaaaaaaaaaaanngggnnaaaaaaaaaaaaaaaaaaaaaaaaaaaaaaaaaaaaaaaaaaaaaaaaaaaaa
aaaaaaaaaaaaaaaaaaaaaaaaaaaaaaaaaaaaaaaaannnnnnnaaaaaaaaaaaaaaaaaaaaaaaaaaaaaaaaaaaaaaaaaaaaaaaaaaaaa
aaaaaaaaaaaaaaaaaaaaaaaaaaaaaaaaaaaaaaaaaaaaaaaaaaaaaaaaaaaaaaaaaaaaaaaaaaaaaaaaaaaaaaaaaaaaaaaaaaaaa
aaaaaaaaaaaaaaaaaaaaaaaaaaaaaaaaaaaaaaaaaaaaaaaaaaaaaaaaaaaaaaaaaaaaaaaaaaaaaaaaaaaaaaaaaaaaaaaaaaaaa
aaaaaaaaaaaaaaaaaaaaaaaaaaaaaaaaaaaaaaaaaaaaaaaaaaaaaaaaaaaaaaaaaaaaaaaaaaaaaaaaaaaaaaaaaaaaaaaaaaaaa
aaaaaaaaaaaaaaaaaaaaaaaaaaaaaaaaaaaaaaaaaaaaaaaaaaaaaaaaaaaaaaaaaaaaaaaaaaaaaaaaaaaaaaaaaaaaaaaaaaaaa
aaaaaaaaaaaaaaaaaaaaaaaaaaaaaaaaaaaaaaaaaaaaaaaaaaaaaaaaaaaaaaaaaaaaaaaaaaaaaaaaaaaaaaaaaaaaaaaaaaaaa
aaaaaaaaaaaaaaaaaaaaaaaaaaaaaaaaaaaaaaaaaaaaaaaaaaaaaaaaaaaaaaaaaaaaaaaaaaaaaaaaaaaaaaaaaaaaaaaaaaaaa
aaaaaaaaaaaaaaaaaaaaaaaaaaaaaaaaaaaaaaaaaaaaaaaaaaaaaaaaaaaaaaaaaaaaaaaaaaaaaaaaaaaaaaaaaaaaaaaaaaaaa
"}
