"a" = (/turf/wall,/area/map)
"b" = (/turf/wall{icon_state = "wall-edge"},/area/map)
"c" = (/obj/item/orb,/turf/floor,/area/map)
"d" = (/turf/floor,/area/map)
"e" = (/turf/checkpoint/start,/area/map)
"f" = (/obj/door/blue,/turf/floor,/area/map)
"g" = (/turf/pit{icon_state = "floor-edge"},/area/map/pit)
"h" = (/obj/trap/spear,/turf/floor,/area/map)
"i" = (/obj/trap/spike,/turf/floor,/area/map)
"j" = (/obj/trap/blade_trail,/turf/floor{icon_state = "floor-hl"},/area/map)
"k" = (/obj/trap/blade_trail,/turf/floor{icon_state = "floor-h"},/area/map)
"l" = (/obj/trap/blade_trail,/obj/trap/blade{dir = 4},/turf/floor{icon_state = "floor-h"},/area/map)
"m" = (/obj/trap/blade_trail,/turf/floor{icon_state = "floor-hr"},/area/map)
"n" = (/turf/pit,/area/map/pit)
"o" = (/obj/item/talaria,/turf/floor,/area/map)
"p" = (/obj/trap/blade_trail,/turf/floor{icon_state = "floor-vt"},/area/map)
"q" = (/obj/trap/blade_trail,/turf/floor{icon_state = "floor-v"},/area/map)
"r" = (/obj/trap/blade_trail,/obj/trap/blade{dir = 8},/turf/floor{icon_state = "floor-h"},/area/map)
"s" = (/obj/trap/blade_trail,/obj/trap/blade,/turf/floor{icon_state = "floor-v"},/area/map)
"t" = (/obj/trap/blade_trail,/turf/floor{icon_state = "floor-vb"},/area/map)
"u" = (/obj/door/yellow,/turf/floor,/area/map)
"v" = (/obj/item/key/red,/turf/floor,/area/map)
"w" = (/turf/checkpoint/yellow_zone,/area/map)
"x" = (/obj/trap/blade_trail,/obj/trap/blade{dir = 1},/turf/floor{icon_state = "floor-v"},/area/map)
"y" = (/turf/checkpoint/blue_zone,/area/map)
"z" = (/obj/door/red,/turf/floor,/area/map)
"A" = (/obj/trap/blade_trail,/obj/trap/blade{dir = 8; speed = 4},/turf/floor{icon_state = "floor-h"},/area/map)
"B" = (/obj/item/key/yellow,/turf/floor,/area/map)
"C" = (/obj/trap/blade_trail,/obj/trap/blade{dir = 4; speed = 4},/turf/floor{icon_state = "floor-h"},/area/map)
"D" = (/obj/item/key/blue,/turf/floor,/area/map)
"E" = (/turf/water{icon_state = "water-edge"},/area/map/water)
"F" = (/turf/water,/area/map/water)
"G" = (/obj/trap/blade_trail,/obj/trap/blade{dir = 1; speed = 4},/turf/floor{icon_state = "floor-vt"},/area/map)
"H" = (/obj/trap/blade_trail,/obj/trap/blade{speed = 4},/turf/floor{icon_state = "floor-v"},/area/map)
"I" = (/turf/checkpoint/green_zone,/area/map)
"J" = (/obj/item/snorkel,/turf/floor,/area/map)
"K" = (/obj/trap/blade_trail,/obj/trap/blade{dir = 1; speed = 4},/turf/floor{icon_state = "floor-v"},/area/map)
"L" = (/obj/trap/blade_trail,/obj/trap/blade{dir = 1; speed = 4},/turf/floor{icon_state = "floor-vb"},/area/map)
"M" = (/obj/item/key/green,/turf/floor,/area/map)
"N" = (/obj/door/green,/turf/floor,/area/map)
"O" = (/turf/flag,/area/map)

(1,1,1) = {"
aaaaaaaaaaaaaaaaaaaaaaaaaaaaaaaaaaaaaaaaaaaaaaaaaaaaaaaaaaaaaaaaaaaaaaaaaaaaaaaaaaaaaaaaaaaaaaaaaaaaa
aaaaaaaaaaaaaaaaaaaaaaaaaaaaaaaaaaaaaaaaaaaaaaaaaaaaaaaaaaaaaaaaaaaaaaaaaaaaaaaaaaaaaaaaaaaaaaaaaaaaa
aaaaaaaaaaaaaaaaaaaaaaaaaaaaaaaaaaaaaaaaaaaaaaaaaaaaaaaaaaaaaaaaaaaaaaaaaaaaaaaaaaaaaaaaaaaaaaaaaaaaa
aaaaaaaaaaaaaaaaaaaaaaaaaaaaaaaaaaaaaaaaaaaaaaaaaaaaaaaaaaaaaaaaaaaaaaaaaaaaaaaaaaaaaaaaaaaaaaaaaaaaa
aaaaaaaaaaaaaaaaaaaaaaaaaaaaaaaaaaaaaaaaaaaaaaaaaaaaaaaaaaaaaaaaaaaaaaaaaaaaaaaaaaaaaaaaaaaaaaaaaaaaa
aaaaaaaaaaaaaaaaaaaaaaaaaaaaaaaaaaaaaaaaaaaaaaaaaaaaaaaaaaaaaaaaaaaaaaaaaaaaaaaaaaaaaaaaaaaaaaaaaaaaa
aaaaaaaaaaaaaaaaaaaaaaaaaaaaaaaaaaaaaaaaaaaaaaaaaaaaaaaaaaaabbbbbbaaaaaaaaaaaaaaaaaaaaaaaaaaaaaaaaaaa
aaaaaaaaaaaaaaaaaaaaaaaaaaaaaaaaaaaaaaaaaaaaaaaaaaaaaaaaaaaaccccccaaaaaaaaaaaaaaabbbaaaaaaaaaaaaaaaaa
aaaaaaaaaaaaaaaaaaaaaaaaaaaaaaaaaaaaaaaaaaaaaaaaaaaaaaaaaabbcaaaacaaaaaaaaaaaaaaadddaaaaaaaaaaaaaaaaa
aaaaaaaaaaaaaaaaaaaaaaaaaaaaaaaaaaaaaaaaaaaaaaaaaaaaaaaaaacccaabbcbbaaaaaaaaaaaaadedaaaaaaaaaaaaaaaaa
aaaaaaaaaaaaaaaaaaaaaaaaaaaaaaaaaaaaaaaaaaaaaaaaaaaaaaaaaacaaaacccccaaaaaaaaaaaaadddaaaaaaaaaaaaaaaaa
aaaaaaaaaaaaaaaaaaaaaaaaaaaaaaaaaaaaaaaaaaaaaaaaaaaaaaabbbcaabbcaaacbbaaaaaaaaaaaacaaaaaaaaaaaaaaaaaa
aaaaaaaaaaaaaaaaaaaaaaaaaaaaaaaaaaaaaaaaaaaaaaaaaaaaaaaccccaacccaaacccaaaaaaaaaaaacaaaaaaaaaaaaaaaaaa
aaaaaaaaaaaaaaaaaaaaaaaaaaaaaaaaaaaaaaaaaaaaaaaaaaaaaaacaacbbcaaaaaaacbbbbbbbbbbbbcbaaaaaaaaaaaaaaaaa
aaaaaaaaaaaaaaaaaaaaaaaaaaaaaaaaaaaaaaaaaaaaaaaaaaaaaaacaaccccaaaaaaaccccccccccccfccaaaaaaaaaaaaaaaaa
aaaaaaaaaaaaaaaaaaaaaaaaaaaaaaaaaaaabbbbbbbbbbaaaaaaaaacaaaaacbbaaabbcaaaaaaaaaaaaacaaaaaaaaaaaaaaaaa
aaaaaaaabbbbbbbbbbbbbaaaaaaaaaaaaaaaccccccccccaaaabbbbbcbbaaacccaaacccaaaaaaaaaaaaacbbbbaaaaaaaaaaaaa
aaaaaaaaggghgiiigggggaaaaaaaaaaaaaaacabbbbbbacaaaacccjklkmaaaaacbbbcaaaaaaaaaaaaaaacccccaaaaaaaaaaaaa
aaaaaaaannnccioinnnnnbbbbbbbbbbbbbbbcaccccccacaaaacaaaacaaaabaacccccaaaaaaaaaaaaaaaiaaacaaaaaaaaaaaaa
aaaaaaaannncgiiinnnnnccccccccccccccccacabbbcacaaaacaaaacaaaapaaaacaaaaaaaaaaaaaaaaaibbbcaaaaaaaaaaaaa
aaaaaaaannncngggnnnnnaaaaaaaaaaaaaabbbcaciicacaaaacaaaacbbbbqbbbbcaaaaaaaaaaaaaaaaacccccaaaaaaaaaaaaa
aaaaaaaannjkkkrkkkmnnaaaaaaaabbbbbaciicacabbbcaaaacaaaacccccscccccaaaaaaaaaaaaaaaaacaaaaaaaaaaaaaaaaa
aaaaaaaannggggcggggnnaaaaaaaagggggacabbbcaccccabbbcbbbaaaaaaqaaaaaaaaaaaaaaaaaaaaaacaaaaaaaaaaaaaaaaa
aaaaaaaannnnnncnnnnnnaaaaaaaannnnnbcaccccagaahahdddddhaaaaaataaaaaaaaaaaaaaaaaaaaaacaaaaaaaaaaaaaaaaa
aaaaaaaannnnnncnnnnnnaaaaaaaanncccccacaaaanaaaadddddddaaaaaacaaaaaaaaaaaaaaaaaaaaaacaaaaaaaaaaaaaaaaa
aaaaaaaannnnnccnnnnnnaaaaaaaanncggaaacabbbnbbbbddgggddbbbbbbcaaaaaaaaaaaaaaaaaaaaaacaaaaaaaaaaaaaaaaa
aaaaaaaannnnncgnpnnnnaaaaaaaanncnnaaacahccccccuddnvnddcccccccaaaaaaaaaaaaaaaaaaaaaacbbbbbbaaaaaaaaaaa
aaaaaaaannnnhcccqnnnnaaaaaaabbbcbbbaacbbcaaaaaaddngnddaabdbaaaaaaaaaaaaaaaaaaaaaaaacccccccaaaaaaaaaaa
aaaaaaaannnnggggqnnnnaaaaaaajkkrkkmaaccccaaaaaadddddddaadddaaaaaaaaaaaaabbbbbbbbbbbbbbabbcaaaaaaaaaaa
aaaaaaaannnnnnnnsnnnnaaaaaaabbbcbbbaaaaahaaaaaahdddddhaadwdaaaaaaaaaaaaaccccccccccccccacccaaaaaaaaaaa
aaaaaaaannnnnnnnqnnnnaaaaaaajkklkkmaaaaaaaaaaaaaapapbaaadddaaaaaaaaaaaaacaaaaaaaaaaaacacaiaaaaaaaaaaa
aaaaaaaannnnhnnnqcnnnaaaaaaabbbcbbbaaaaaaaaaaaaaaqaqhaaaaaaaaaaaaaaaaaaacaaaaaaaaaabbcacbiaaaaaaaaaaa
aaaaaaaannnncccctgnnnaaaaaaajkkrkkmaaaaaaaaaaaaaaqbqaaaaaaaaaaaaaaaaaaaacaaaaaaaaaacccacccaaaaaaaaaaa
aaaaaaaannnncggggnnnnaaaaaaaaaacaaaaaaaaaaaaaaaaaqcqaaaaaaaaaaaaaaaaaaaacaaaaaaaaaacacbbacaaaaaaaaaaa
aaaaaaaannnncccnnnnnnaaaaaaaaaacaaaaaaaaaaaaaaaabqaqaaaaaaaaaaaaaaaabbbbcabbbaaaaaacacccacaaaaaaaaaaa
aaaaaaaannnnggcnnnnnnaaabbbbbbbcaaaaaaaaaaaaaaaahqaqaaaaaaaaaaaaaaaapccccaccpaaaaaacaaacacaaaaaaaaaaa
aaaaaaaannjkkkrkkkmnnaaaggggccccaaaaaaaaaaaaaaaaaqbqaaaaaaaaaaaaaaaaqaaaaaaaqaaaaaacaaacacaaaaaaaaaaa
aaaaaaaannggggcggggnnaaanabacaaaaaaaaaaaaaaaaaaaascxaaaaaaaaaaaaaaaaqaabbbaaqaaaaaacaaacacaaaaaaaaaaa
aaaaaaaannnnnncncccnnaaanapacaaaaaaaaaaaaaaaaaaaaqaqbaaaaaaaaaaaaaaaqbadddabqaaaaaacaaacacbbbaaaaaaaa
aaaaaaaannnnnncncgcnnbbbnbqbcaaaaaaaaaaaaaaaaaaaaqaqhaaaaaaaaaaaaaaascadydacsaaaaaacaaacaccccaaaaaaaa
aaaaaaaannnnnncccncnccccccsccaaaaaaaaaaaaaaaaaaaaqbqaaaaaaaaaaaaaaaaqaadddaaqbbbaaacaaaiaaaaiaaaaaaaa
aaaaaaaannnnnngggncncaaaaaqaaaaaaaaaaaaaaaaabaaaaqcqaaaaaaaaaaaaaaaaqaaadaaaqcccaaacaaaibbbbiaaaaaaaa
aaaaaaaannnnnnnnnncccaaaaataaaaaaaaaaaabbbbbhaaabqaqaaaaaaaaaaaaaaaaqbbbdbbbqaacaaacaaaccccccaaaaaaaa
aaaaaaaaaaaaaaaaaaaaaaaaaaaaaaaaaaaaaaahcccccaaahqaqaaaaaaaaaaaaaaaatccccccctaacaaacaaaaaaaaaaaaaaaaa
aaaaaaaaaaaaaaaaaaaaaaaaaaaaaaaaaaaaaaaacabbcaaabtbtbaaaaaaaaaaaaaaaaaaacaaaaaacbbbcaaaaaaaaaaaaaaaaa
aaaaaaaaaaaaaaaaaaaaaaaaaaaaaaaaaaaaaaaacacccaaahdddhaaaaaaaaaaaaaaaaaaacaaaaaacccccaaaaaaaaaaaaaaaaa
aaaaaaaaaaaaaaaaaaaaaaaaaaaaaaaaaaaaaaaaiaiabbbbdddddbbbbbbbbaaaaaaaaaaacaaaaaaaaaaaaaaaaaaaaaaaaaaaa
aaaaaaaaaaaaaaaaaaaaaaaaaaabbbbbbbbbbbaaiaiaccccddhddzcccccccaaaaaaaaaaacaaaaaaaaaaaaaaaaaaaaaaaaaaaa
aaaaaaaaaaaaaaaaaaaaaaaaaaagggggggggggaaiaibcaaadddddaaaabbbcbbbaaaaaaaacaaaaaaaaaaaaaaaaaaaaaaaaaaaa
aaaaaaaaaaaaaaaaaaaaaaaaaaannnnnncccnnaacacccaaahdddhaaaajkkAkkmaaaaaaaacaaaaaaaaaaaaaaaaaaaaaaaaaaaa
aaaaaaaaaaaaaaaaaaaaaaaaaaanccccncgcnnaacbbbbbbaaaaaaaaaaabbcaaaaaaaaaaacaaaaaaaaaaaaaaaaaaaaaaaaaaaa
aaaaaaaaaaaaaaaaaaaaaaaaaaancggcncncnnaacccccccaaaaaaaaaaacccaaaaaaabbbbcbbbbaaaaaaaaaaaaaaaaaaaaaaaa
aaaaaaaaaaaaaaaaaaaaaaaaaaaiiincncncnnbbbbbbbacbbbbbbbabbbcbbbaaaaaajkkkrkkkmaaaaaaaaaaaaaaaaaaaaaaaa
aaaaaaaaaaaaaaaaaaaaaaaaaaaiBincncnccccccccccacciiicchajkkCkkmaaaaaaggggggcggaaaaaaaaaaaaaaaaaaaaaaaa
aaaaaaaaaaaaaaaaaaaaaaaaaaaiiincncngggaaaaabcbbbbbbbcaaaaacbbaaaaaaajkkklkkkmaaaaaaaaaaaaaaaaaaaaaaaa
aaaaaaaaaaaaaaaaaaaaaaaaaaagggncnccccnaaaaahcccciiiccaaaaacccaaaaaaaggcggggggaaaaaaaaaaaaaaaaaaaaaaaa
aaaaaaaaaaaaaaaaaaaaaaaaaaannnncngggcnaaaaaaaaaaaaaahaaaabbbcbbbaaaajkkkrkkkmaaaaaaaaaaaaaaaaaaaaaaaa
aaaaaaaaaaaaaaaaaaaaaaaaaaannnnccccccnaaaaaaaaaaaaaaaaaaajkkAkkmaaaaggggcggggaaaaaaaaaaaaaaaaaaaaaaaa
aaaaaaaaaaaaaaaaaaaaaaaaaaannnnggggggnaaaaaaaaaaaaaaaaaaaabbcaaaaaaannnncnnnnaaaaaaaaaaaaaaaaaaaaaaaa
aaaaaaaaaaaaaaaaaaaaaaaaaaaaaaaaaaaaaaaaaaaaaaaaaaaaaaaaaacccaaaaaaannnncnnnnaaaaaaaaaaaaaaaaaaaaaaaa
aaaaaaaaaaaaaaaaaaaaaaaaaaaaaaaaaaaaaaaaaaaaaaaaaaaaaaabbbcbbbaaaaaannnccnnnnaaaaaaaaaaaaaaaaaaaaaaaa
aaaaaaaaaaaaaaaaaaaaaaaaaaaaaaaaaaaaaaaaaaaaaaaaaaaaaaajkkCkkmaaaaaannncgnnnnaaaaaaaaaaaaaaaaaaaaaaaa
aaaaaaaaaaaaaaaaaaaaaaaaaaaaaaaaaaaaaaaaaaaaaaaaaaaaaaaaaacaaaaaaaaannncccnnnaaaaaaaaaaaaaaaaaaaaaaaa
aaaaaaaaaaaaaaaaaaaaaaaaaaaaaaaaaaaaaaaaaaaaaaaaaaaaaaaabbcbbaaaaaaannnggcnnnaaaaaaaaaaaaaaaaaaaaaaaa
aaaaaaaaaaaaaaaaaaaaaaaaaaaaaaaaaaaaaaaaaaaaaaaaaaaaaaaagggggaaaaaaannnnccnnnaaaaaaaaaaaaaaaaaaaaaaaa
aaaaaaaaaaaaaaaaaaaaaaaaaaaaaaaaaaaaaaaaaaaaaaaaaaaaaaaajkCkmaaaaaaannnncgnnnaaaaaaaaaaaaaaaaaaaaaaaa
aaaaaaaaaaaaaaaaaaaaaaaaaaaaaaaaaaaaaaaaaaaaaaaaaaaaaaaagggggaaaaaaannndddnnnaaaaaaaaaaaaaaaaaaaaaaaa
aaaaaaaaaaaaaaaaaaaaaaaaaaaaaaaaaaaaaaaaaaaaaaaaaaaaaaaajkAkmaaaaaaannndDdnnnaaaaaaaaaaaaaaaaaaaaaaaa
aaaaaaaaaaaaaaaaaaaaaaaaaaaaaaaaaaaaaaaaaaaaaaaaaaaaaaaagggggaaaaaaannndddnnnaaaaaaaaaaaaaaaaaaaaaaaa
aaaaaaaaaaaaaabbbbbbbbbbbbbbbbbbbbbbbbbaaaaaaaaaaaaaaaaajkCkmaaaaaaaaaaaaaaaaaaaaaaaaaaaaaaaaaaaaaaaa
aaaaaaaaaaaaaaEEEEEEEEEEEEEEEEEEEEEEEEEaaaaaaaaaaaaaaaaagggggaaaaaaaaaaaaaaaaaaaaaaaaaaaaaaaaaaaaaaaa
aaaaaaaaaaaaaaFFFFFFFFFFaaaadpppppGpppdabbbaaabbbbbbbaaajkAkmaaaaaaaaaaaaaaaaaaaaaaaaaaaaaaaaaaaaaaaa
aaaaaaaaaaaaaaFFFFFFFFFFaaaadqqqqqqqqqdbdddaaacccccccaaagggggaaaaaaaaaaaaaaaaaaaaaaaaaaaaaaaaaaaaaaaa
aaaaaaaaaaaaaaFFFFFFFFFFaaaadqqqqqqHqqdddIdaaacEEEEEcaaajkCkmaaaabbbbbaaaaaaaaaaaaaaaaaaaaaaaaaaaaaaa
aaaaaaaaaaaaaaFFFFFFFFFFaaaadqqqqqqqqqdadddaaacFFFFFcaaagggggaaaaEEEEEaaaaaaaaaaaaaaaaaaaaaaaaaaaaaaa
aaaaaaaaaaaaaahdhFFFFFFFbbbbdqqHqqqqqqdbbbaaaacFFFFFcbbbbhdhbbbbbFFFFFaaaaaaaaaaaaaaaaaaaaaaaaaaaaaaa
aaaaaaaaaaaaaadJdiiicFFFciiidqKqqHqqKqdcccaaaacFFFFFcccccdddcccccFFFFFaaaaaaaaaaaaaaaaaaaaaaaaaaaaaaa
aaaaaaaaaaaaaahdhEEEcFFFcaaadHqqqqqqqqdaacaaaacFFFFFaaaaahdhaaaaaFFFFFaaaaaaaaaaaaaaaaaaaaaaaaaaaaaaa
aaaaaaaaaaaaaaEEEFFFcFFFcaaadqqqqqqqqqdaacbbbbcbbbaaaaaaaaaaaaaaaFFFFFaaaaaaaaaaaaaaaaaaaaaaaaaaaaaaa
aaaaaaaaaaaaaaFFFFFFciiicaaadqqqqqqqqHdaacccccccccaaaaaaaaaaaaaaaaFFFaaaaaaaaaaaaaaaaaaaaaaaaaaaaaaaa
aaaaaaaaaaaaaaFFFFFFEEEEaaaadqqqqqqqqqdaaaaaaaaaacaaaaaaaaaaaaaaaajAmaaaaaaaaaaaaaaaaaaaaaaaaaaaaaaaa
aaaaaaaaaaaaaaFFFFFFFFFFbbbbdtttLtttttdaaaaaaaaaacaaaaaaaaaaaaaaaaEEEaaaaaaaaaaaaaaaaaaaaaaaaaaaaaaaa
aaaaaaaaaaaaaaFFFFFFFFFFEEEEEEEEEEEEEEEaaaaaaaaaacaaaaaaaaaaaaaaaajCmaaaaaaaaaaaaaaaaaaaaaaaaaaaaaaaa
aaaaaaaaaaaaaaaaaaaaaaaaaaaaaaaaaaaaaaaaaaaaaaaaacaaaaaaaaaaaaaaaaEEEaaaaaaaaaaaaaaaaaaaaaaaaaaaaaaaa
aaaaaaaaaaaaaaaaaaaaaaaaaaaaaaaaaaaaaaaaaaaaaabbbcaaaaaaaaaaaaaaaajAmaaaaaaaaaaaaaaaaaaaaaaaaaaaaaaaa
aaaaaaaaaaaaaaaaaaaaaaaaaaaaaaaaaaaaaaaaaaaaaaciicaaaaaaaaaaaaaaabEEEbaaaaaaaaaaaaaaaaaaaaaaaaaaaaaaa
aaaaaaaaaaaaaaaaaaaaaaaaaaaaaaaaaaaaaaaaaaaabbcaaaaaaaaaaaaaaaaaaEFFFEaaaaaaaaaaaaaaaaaaaaaaaaaaaaaaa
aaaaaaaaaaaaaaaaaaaaaaaaaaaaaaaaaaaaaaaaaaaacccaaaaaaaaaaaaaaaaaaFdddFaaaaaaaaaaaaaaaaaaaaaaaaaaaaaaa
aaaaaaaaaaaaaaaaaaaaaaaaaaaaaaaaaaaaaaaaaaaaiahaaaaaaaaaaaaaaaaaaFdMdFaaaaaaaaaaaaaaaaaaaaaaaaaaaaaaa
aaaaaaaaaaaaaaaaaaaaaaaaaaaaaaaaaaaaaaaaaaaaibbbaaaaaaaaaaaaaaaaaFdddFaaaaaaaaaaaaaaaaaaaaaaaaaaaaaaa
aaaaaaaaaaaaaaaaaaaaaaaaaaaaaaaaaaaaaaaaaaaaccchaaaaaaaaaaaaaaaaaFEEEFaaaaaaaaaaaaaaaaaaaaaaaaaaaaaaa
aaaaaaaaaaaaaaaaaaaaaaaaaaaaaaaaaaaaaaaaaaaaaaiaaaaaaaaaaaaaaaaaaaaaaaaaaaaaaaaaaaaaaaaaaaaaaaaaaaaaa
aaaaaaaaaaaaaaaaaaaaaaaaaaaaaaaaaaaaaaaaaaabbbiaaaaaaaaaaaaaaaaaaaaaaaaaaaaaaaaaaaaaaaaaaaaaaaaaaaaaa
aaaaaaaaaaaaaaaaaaaaaaaaaaaaaaaaaaaaaaaaaaahcccaaaaaaaaaaaaaaaaaaaaaaaaaaaaaaaaaaaaaaaaaaaaaaaaaaaaaa
aaaaaaaaaaaaaaaaaaaaaaaaaaaaaaaaaaaaaaaaaaaaiaaaaaaaaaaaaaaaaaaaaaaaaaaaaaaaaaaaaaaaaaaaaaaaaaaaaaaaa
aaaaaaaaaaaaaaaaaaaaaaaaaaaaaaaaaaaaaaaaaaaaiaaaaaaaaaaaaaaaaaaaaaaaaaaaaaaaaaaaaaaaaaaaaaaaaaaaaaaaa
aaaaaaaaaaaaaaaaaaaaaaaaaaaaaaaaaaaaaaaaabbbNbbbaaaaaaaaaaaaaaaaaaaaaaaaaaaaaaaaaaaaaaaaaaaaaaaaaaaaa
aaaaaaaaaaaaaaaaaaaaaaaaaaaaaaaaaaaaaaaaagggggggaaaaaaaaaaaaaaaaaaaaaaaaaaaaaaaaaaaaaaaaaaaaaaaaaaaaa
aaaaaaaaaaaaaaaaaaaaaaaaaaaaaaaaaaaaaaaaannnnnnnaaaaaaaaaaaaaaaaaaaaaaaaaaaaaaaaaaaaaaaaaaaaaaaaaaaaa
aaaaaaaaaaaaaaaaaaaaaaaaaaaaaaaaaaaaaaaaanndddnnaaaaaaaaaaaaaaaaaaaaaaaaaaaaaaaaaaaaaaaaaaaaaaaaaaaaa
aaaaaaaaaaaaaaaaaaaaaaaaaaaaaaaaaaaaaaaaanndOdnnaaaaaaaaaaaaaaaaaaaaaaaaaaaaaaaaaaaaaaaaaaaaaaaaaaaaa
aaaaaaaaaaaaaaaaaaaaaaaaaaaaaaaaaaaaaaaaanndddnnaaaaaaaaaaaaaaaaaaaaaaaaaaaaaaaaaaaaaaaaaaaaaaaaaaaaa
aaaaaaaaaaaaaaaaaaaaaaaaaaaaaaaaaaaaaaaaanngggnnaaaaaaaaaaaaaaaaaaaaaaaaaaaaaaaaaaaaaaaaaaaaaaaaaaaaa
aaaaaaaaaaaaaaaaaaaaaaaaaaaaaaaaaaaaaaaaannnnnnnaaaaaaaaaaaaaaaaaaaaaaaaaaaaaaaaaaaaaaaaaaaaaaaaaaaaa
aaaaaaaaaaaaaaaaaaaaaaaaaaaaaaaaaaaaaaaaaaaaaaaaaaaaaaaaaaaaaaaaaaaaaaaaaaaaaaaaaaaaaaaaaaaaaaaaaaaaa
aaaaaaaaaaaaaaaaaaaaaaaaaaaaaaaaaaaaaaaaaaaaaaaaaaaaaaaaaaaaaaaaaaaaaaaaaaaaaaaaaaaaaaaaaaaaaaaaaaaaa
aaaaaaaaaaaaaaaaaaaaaaaaaaaaaaaaaaaaaaaaaaaaaaaaaaaaaaaaaaaaaaaaaaaaaaaaaaaaaaaaaaaaaaaaaaaaaaaaaaaaa
aaaaaaaaaaaaaaaaaaaaaaaaaaaaaaaaaaaaaaaaaaaaaaaaaaaaaaaaaaaaaaaaaaaaaaaaaaaaaaaaaaaaaaaaaaaaaaaaaaaaa
aaaaaaaaaaaaaaaaaaaaaaaaaaaaaaaaaaaaaaaaaaaaaaaaaaaaaaaaaaaaaaaaaaaaaaaaaaaaaaaaaaaaaaaaaaaaaaaaaaaaa
aaaaaaaaaaaaaaaaaaaaaaaaaaaaaaaaaaaaaaaaaaaaaaaaaaaaaaaaaaaaaaaaaaaaaaaaaaaaaaaaaaaaaaaaaaaaaaaaaaaaa
aaaaaaaaaaaaaaaaaaaaaaaaaaaaaaaaaaaaaaaaaaaaaaaaaaaaaaaaaaaaaaaaaaaaaaaaaaaaaaaaaaaaaaaaaaaaaaaaaaaaa
"}
